You struggle and cry for help, but your captor ignores your feeble pleas.  They toss you, like garbage, into the darkness.  The heavy gate closes and locks behind you, sealing your fate.  Their maniacal laughter echoes into the distance, leaving you alone with your thoughts.

You are trapped.  Trapped...  in the Chamber of Despair.

Star Anise Chronicles: Escape from the Chamber of Despair
An Interactive Fiction by Evelyn Woods
Release 1 / Serial number 191221 / Inform 7 build 6M62 (I6/v6.33 lib 6/12N) SD

Neon's bedroom
The lights are off and there are no windows, but the room is lit well enough by the cyan glow coming from Neon's desk and the blinking LEDs on the tall machine in the corner.

The desk, with a drawer underneath, and an adjacent workbench run along the entire length of one wall.  Some shelves take up the opposite wall, stopping short of the corner to make room for a tall machine.  In the center of the room is a bed, unmade, a blanket hanging half off one side; it's framed by a nightstand and a closet door in the western wall.  The bedroom door to the east is closed, of course, but the glowing panel next to it might be useful.

A little white pamphlet lies on the floor near the door.

The floor is strewn with innumerable strata of dirty laundry, all of which is soft and comfortable under your paws.

(From down here, you can't see what's on the various raised surfaces around the room.)

[on the floor]

>i
Your paws are empty.

>nouns
At the moment, "it" means the bed, "him" is unset, "her" is unset and "them" is unset.

>x purrl
You see nothing special about Purrl.

* * *

>get on bed
You get onto the bed.

The blanket laying haphazardly across the bed bears a circuit pattern that matches the pillow, as well as a conspicuous lump in the middle.

[on the bed]

>climb bed
Little is to be achieved by that.

>sit on bed
That's not something you can sit down on.

>go on bed
You can't see any such thing.

>x bed
On the bed are a pillow and a blanket.

* * *

>get on bed
You get onto the bed.

The blanket laying haphazardly across the bed bears a circuit pattern that matches the pillow, as well as a conspicuous lump in the middle.

[on the bed]

>pull blanket
You reel the blanket towards you with your little pest paws, and it slides away from the lump to reveal Purrl.  She hops to her feet, bewildered, but her expression darkens when she notices you.

Purrl crosses her arms.  "Star Anise!!  What are you doing here!  I was taking a lovely nap, and then I had a nightmare that Star Anise woke me up, and then it wasn't a nightmare it was real!!  This is my sleep place that I found, go away!!"

You adopt an action pose, to convey how much action you're currently ready for.  "Oh!!!!!  Purrl!  I'm so glad to see you!!  Listen we're trapped in the Chamber of Despair and I've been trying to go away but I can't because of the trapped!  We gotta make a daringly cool escape!!  Do you have any explosives or maybe a cool gun."

"No!  Let me nap!!!"

"Yeah!!  A nap after we escape sounds great!!  Team Star Purrl Anise Fish Squad let's go!!"

Purrl hops down off of the bed.

[Your score has just gone up by five points.]

What a fortuitous turn of events!  You practically vibrate with excitement.  "Oh!  Purrl!!!  I'm so glad to see you!!!!!  Listen we're trapped in the Chamber of Despair and we gotta make a daring but cool escape!!"

Purrl frowns harder.  You really don't understand how she does that with her eyebrows.  "No!  Go away!!  I just want to nap!"

You sigh.  It's a good thing you're so patient.  Sometimes Purrl just doesn't get it.  "I'm trying to go away!!  From this room!!  But I can't!!!"

Purrl taps her chin.  "So to escape Star Anise...  I have to help Star Anise escape."  She re-frowns and crosses her arms.  "Fine!!  But I'll do lovely help only."

"Yeah!!  Teaming up again let's go!!  Team Star Purrl Anise Fish Squad!!"

>show panel to purrl
You can't see any such thing.

>x panel
This glowing rectangle is clearly the secret to your escape.  Also, it glows, and that makes you want to touch it very badly.

>actions
Actions listing on.

>show panel to purrl
You can't see any such thing.

>show purrl panel
You can't see any such thing.

>show glowing panel to purrl
You can't see any such thing.

>tell purrl about panel
You can't see any such thing.

>x purrl
You can't see any such thing.

>look
[looking]
Neon's bedroom (on the bed)
The lights are off and there are no windows, but the room is lit well enough by the cyan glow from the terminal on Neon's desk and the blinking LEDs on the strange machine in the corner.

The desk and an adjacent workbench run along the entire length of one wall.  shelves take up the opposite wall, except for a strange machine in the corner.  In the center of the room is a bed, unmade; beside it is a nightstand, then a closet door.  The bedroom door is, of course, closed behind you.

The floor is strewn with innumerable strata of dirty laundry, which is soft and nice to stand on.

On the bed you can see a pillow and a blanket.

[looking - succeeded]

* * *

>down
You hop down off of the bed.

Neon's bedroom
The lights are off and there are no windows, but the room is lit well enough by the cyan glow coming from Neon's desk and the blinking LEDs on the tall machine in the corner.

The desk and an adjacent workbench run along the entire length of one wall.  Some shelves take up the opposite wall, stopping short of the corner to make room for a tall machine.  In the center of the room is a bed, unmade, a blanket hanging half off one side; it's framed by a nightstand and a closet door in the western wall.  The bedroom door to the east is, of course, closed.

From down here, you can't see what's on the various raised surfaces around the room: the bed, nightstand, desk, workbench, and shelves.

A little white pamphlet lies on the floor near the door.

The floor is strewn with innumerable strata of dirty laundry, all of which is soft and comfortable under your paws.  Purrl has found a nice shirt to wrap around herself.  Also on the floor are a glue stick and a bag of glitter.

>z
Time passes.

>z
Time passes.

>show panel to purrl
You point up at the panel.  "I think that opens the door!!  Also it glows a lot and I wanna touch it.  But it's too tall up!  Gimme a boost!"

Purrl puts her paws squarely on her hips.  "I'm not giving you any boots!  Find something else to stand on!!"

"Like what??  Everything in here is real big or real shirt!"  You stand on one of the dirty shirts on the floor.  "Look it doesn't make me any taller at all!  Not even one taller."

"Mmmmnnmnnmm, I dunno."  Purrl licks her paw in a lovely manner.  "But okay.  But only if you don't bother M.O.R.S.E.L."

[Your score has just gone up by five points.]

>climb on purrl
You climb awkwardly on top of Purrl's helmet.

Purrl clears her throat loudly.

>get on bed
Purrl frowns and shakes her head.  "I'm just giving you boots, Star Anise!!  I'm not carrying you around like a horse!  Don't horse me!"

Purrl sighs dramatically.

* * *

>get on bed
You get onto the bed.

The blanket laying haphazardly across the bed bears a circuit pattern that matches the pillow, as well as a conspicuous lump in the middle.

[on the bed]

>touch door
Which do you mean, the 1) closet door or the 2) bedroom door?

>2
The bedroom door is too far away!  You'll have to get closer.

>pull blanket
You reel the blanket towards you with your little pest paws, and it slides away from the lump to reveal Purrl.  She hops to her feet, bewildered, but her expression darkens when she notices you.

Purrl crosses her arms.  "Star Anise!!  What are you doing here!  I was taking a lovely nap, and then I had a nightmare that Star Anise woke me up, and then it wasn't a nightmare it was real!!  This is my sleep place that I found, go away!!"

You adopt an action pose, to convey how much action you're currently ready for.  "Oh!!!!!  Purrl!  I'm so glad to see you!!  Listen we're trapped in the Chamber of Despair and I've been trying to go away but I can't because of the trapped!  We gotta make a daringly cool escape!!  Do you have any explosives or maybe a cool gun."

"No!  Let me nap!!!"

"Yeah!!  A nap after we escape sounds great!!  Team Star Purrl Anise Fish Squad let's go!!"

>get on purrl
You climb awkwardly on top of Purrl.

* * *

>get on bed
You get onto the bed.

The blanket laying haphazardly across the bed bears a circuit pattern that matches the pillow, as well as a conspicuous lump in the middle.

[on the bed]

>showme bed
bed - platform
    yourself - person
    pillow
    blanket
        lump (part of blanket)
location: in Neon's bedroom
singular-named, improper-named; unlit, inedible, fixed in place, scenery, seen, familiar; enterable
list grouping key: none
printed name: "bed"
printed plural name: "platforms"
indefinite article: none
description: "The blanket strewn haphazardly across the bed bears a circuit pattern that matches the pillow, as well as a conspicuous lump in the middle.
"
initial appearance: none
disambiguation id: 0
carrying capacity: 100

* * *

>get on bed
You get onto the bed.

The blanket laying haphazardly across the bed bears a circuit pattern that matches the pillow, as well as a conspicuous lump in the middle.

[on the bed]

>x blanket
The blanket is soft, fuzzy, warm, and much bigger than you.  Everything you ever wanted.  Not just in a blanket, but in general.

A conspicuous lump rises out of the middle of it.

>down
You get off the bed.

Neon's bedroom
The lights are off and there are no windows, but the room is lit well enough by the cyan glow coming from Neon's desk and the blinking LEDs on the strange machine in the corner.

The desk and an adjacent workbench run along the entire length of one wall.  Some shelves take up the opposite wall, stopping short of the corner to make room for a strange machine.  In the center of the room is a bed, unmade, a blanket hanging half off one side; it's framed by a nightstand and a closet door.  The bedroom door is, of course, closed behind you.

From the floor, you can't see what's on the various raised surfaces around the room: the bed, nightstand, desk, workbench, and shelves.

>x blanket
The blanket is soft, fuzzy, warm, and much bigger than you.  Everything you ever wanted.  Not just in a blanket, but in general.

>get on bed
You get onto the bed.

The blanket strewn haphazardly across the bed bears a circuit pattern that matches the pillow, as well as a conspicuous lump in the middle.

>pull blanket
You reel the blanket towards you with your little pest paws, and it slides away from the lump to reveal Purrl.  She hops to her feet, bewildered, but her expression darkens when she notices you.

Purrl crosses her arms.  "Star Anise!!  What are you doing here!  I was taking a lovely nap, and then I had a nightmare that Star Anise woke me up, and then it wasn't a nightmare it was real!!  This is my sleep place that I found, go away!!"

You adopt an action pose, to convey how much action you're currently ready for.  "Oh!!!!!  Purrl!  I'm so glad to see you!!  Listen we're trapped in the Chamber of Despair and I've been trying to go away but I can't because of the trapped!  We gotta make a daringly cool escape!!  Do you have any explosives or maybe a cool gun."

"No!  Let me nap!!!"

"Yeah!!  A nap after we escape sounds great!!  Team Star Purrl Anise Fish Squad let's go!!"

[Your score has just gone up by five points.]

>look
Neon's bedroom (on the bed)
The lights are off and there are no windows, but the room is lit well enough by the cyan glow coming from Neon's desk and the blinking LEDs on the strange machine in the corner.

The desk and an adjacent workbench run along the entire length of one wall.  Some shelves take up the opposite wall, stopping short of the corner to make room for a strange machine.  In the center of the room is a bed, unmade, a blanket hanging half off one side; it's framed by a nightstand and a closet door.  The bedroom door is, of course, closed behind you.

From your vantage point atop the bed, you could see what's on the various other raised surfaces around the room (the nightstand, desk, workbench, and shelves), if you cared to take a look.
The blanket strewn haphazardly across the bed bears a circuit pattern that matches the pillow.

>showme bed
bed - platform
    Purrl - rideable animal
    yourself - person
    pillow
    blanket
location: in Neon's bedroom
singular-named, improper-named; unlit, inedible, fixed in place, seen, familiar; enterable
list grouping key: none
printed name: "bed"
printed plural name: "platforms"
indefinite article: none
description: none
initial appearance: "The blanket strewn haphazardly across the bed bears a circuit pattern that matches the pillow.
"
disambiguation id: 0
carrying capacity: 100

* * *

>get on bed
You get onto the bed.

The blanket laying haphazardly across the bed bears a circuit pattern that matches the pillow, as well as a conspicuous lump in the middle.

[on the bed]

>get on nightstand
You get onto the nightstand.

This little platform is the perfect size for you!

>down
You get off the nightstand.

Neon's bedroom
The lights are off and there are no windows, but the room is lit well enough by the cyan glow coming from Neon's desk and the blinking LEDs on the tall machine in the corner.

The desk and an adjacent workbench run along the entire length of one wall.  Some shelves take up the opposite wall, stopping short of the corner to make room for a tall machine.  In the center of the room is a bed, unmade, a blanket hanging half off one side; it's framed by a nightstand and a closet door in the western wall.  The bedroom door to the east is, of course, closed.

From down here, you can't see what's on the various raised surfaces around the room: the bed, nightstand, desk, workbench, and shelves.

A little white pamphlet lies on the floor near the door.

The floor is strewn with innumerable strata of dirty laundry, all of which is soft and comfortable under your paws.  Also on the floor are a glue stick and a bag of glitter.

>rules
Rules tracing now switched on. Type "rules off" to switch it off again, or "rules all" to include even rules which do not apply.

* * *

>get on bed
You get onto the bed.

The blanket laying haphazardly across the bed bears a circuit pattern that matches the pillow, as well as a conspicuous lump in the middle.

[on the bed]

>look
Neon's bedroom (on the bed)
The lights are off and there are no windows, but the room is lit well enough by the cyan glow coming from Neon's desk and the blinking LEDs on the tall machine in the corner.

The desk and an adjacent workbench run along the entire length of one wall.  Some shelves take up the opposite wall, stopping short of the corner to make room for a tall machine.  In the center of the room is a bed, unmade, a blanket hanging half off one side; it's framed by a nightstand and a closet door in the western wall.  The bedroom door to the east is, of course, closed.

From your vantage point atop the bed, you could see what's on the various other raised surfaces around the room (the nightstand, desk, workbench, and shelves), if you cared to take a look.

A little white pamphlet lies on the floor near the door.

The floor is strewn with innumerable strata of dirty laundry, all of which is soft and comfortable under your paws.  Also on the floor are a glue stick and a bag of glitter.

The blanket strewn haphazardly across the bed bears a circuit pattern that matches the pillow, as well as a conspicuous lump in the middle.

>take pillow
You pick up the pillow.

>look
Neon's bedroom (on the bed)
The lights are off and there are no windows, but the room is lit well enough by the cyan glow coming from Neon's desk and the blinking LEDs on the tall machine in the corner.

The desk and an adjacent workbench run along the entire length of one wall.  Some shelves take up the opposite wall, stopping short of the corner to make room for a tall machine.  In the center of the room is a bed, unmade, a blanket hanging half off one side; it's framed by a nightstand and a closet door in the western wall.  The bedroom door to the east is, of course, closed.

From your vantage point atop the bed, you could see what's on the various other raised surfaces around the room (the nightstand, desk, workbench, and shelves), if you cared to take a look.

A little white pamphlet lies on the floor near the door.

The floor is strewn with innumerable strata of dirty laundry, all of which is soft and comfortable under your paws.  Also on the floor are a glue stick and a bag of glitter.

The blanket strewn haphazardly across the bed bears a circuit pattern, as well as a conspicuous lump in the middle.

>drop pillow
Dropped.

>look
Neon's bedroom (on the bed)
The lights are off and there are no windows, but the room is lit well enough by the cyan glow coming from Neon's desk and the blinking LEDs on the tall machine in the corner.

The desk and an adjacent workbench run along the entire length of one wall.  Some shelves take up the opposite wall, stopping short of the corner to make room for a tall machine.  In the center of the room is a bed, unmade, a blanket hanging half off one side; it's framed by a nightstand and a closet door in the western wall.  The bedroom door to the east is, of course, closed.

From your vantage point atop the bed, you could see what's on the various other raised surfaces around the room (the nightstand, desk, workbench, and shelves), if you cared to take a look.

A little white pamphlet lies on the floor near the door.

The floor is strewn with innumerable strata of dirty laundry, all of which is soft and comfortable under your paws.  Also on the floor are a glue stick and a bag of glitter.

The blanket strewn haphazardly across the bed bears a circuit pattern that matches the pillow, as well as a conspicuous lump in the middle.

>x bed
This big cat bed is for the big cat.  Sometimes she shares it with you, but only if she's asleep already.

On the bed are a pillow and a blanket.

>push pillow
Nothing obvious happens.

>kick pillow
Nothing obvious happens.

>look
Neon's bedroom (on the bed)
The lights are off and there are no windows, but the room is lit well enough by the cyan glow coming from Neon's desk and the blinking LEDs on the tall machine in the corner.

The desk and an adjacent workbench run along the entire length of one wall.  Some shelves take up the opposite wall, stopping short of the corner to make room for a tall machine.  In the center of the room is a bed, unmade, a blanket hanging half off one side; it's framed by a nightstand and a closet door in the western wall.  The bedroom door to the east is, of course, closed.

From your vantage point atop the bed, you could see what's on the various other raised surfaces around the room (the nightstand, desk, workbench, and shelves), if you cared to take a look.

A little white pamphlet lies on the floor near the door.

The floor is strewn with innumerable strata of dirty laundry, all of which is soft and comfortable under your paws.  Also on the floor are a glue stick and a bag of glitter.

The blanket strewn haphazardly across the bed bears a circuit pattern that matches the pillow, as well as a conspicuous lump in the middle.

* * *

>get on bed
You get onto the bed.

The blanket laying haphazardly across the bed bears a circuit pattern that matches the pillow, as well as a conspicuous lump in the middle.

[on the bed]

>down
You hop down off of the bed.

Neon's bedroom
The lights are off and there are no windows, but the room is lit well enough by the cyan glow coming from Neon's desk and the blinking LEDs on the tall machine in the corner.

The desk, with a drawer underneath, and an adjacent workbench run along the entire length of one wall.  Some shelves take up the opposite wall, stopping short of the corner to make room for a tall machine.  In the center of the room is a bed, unmade, a blanket hanging half off one side; it's framed by a nightstand and a closet door in the western wall.  The bedroom door to the east is closed, of course, but the glowing panel next to it might be useful.

A little white pamphlet lies on the floor near the door.

The floor is strewn with innumerable strata of dirty laundry, all of which is soft and comfortable under your paws.

(From down here, you can't see what's on the various raised surfaces around the room.)

[on the floor]

>get on bed
You get onto the bed.

The blanket laying haphazardly across the bed bears a circuit pattern that matches the pillow, as well as a conspicuous lump in the middle.

[on the bed]

>rules
Rules tracing now switched on. Type "rules off" to switch it off again, or "rules all" to include even rules which do not apply.

[on the bed]

* * *

>get on bed
You get onto the bed.

The blanket laying haphazardly across the bed bears a circuit pattern that matches the pillow, as well as a conspicuous lump in the middle.

[on the bed]

>get down
You hop down off of the bed.

Neon's bedroom
The lights are off and there are no windows, but the room is lit well enough by the cyan glow coming from Neon's desk and the blinking LEDs on the tall machine in the corner.

The desk, with a drawer underneath, and an adjacent workbench run along the entire length of one wall.  Some shelves take up the opposite wall, stopping short of the corner to make room for a tall machine.  In the center of the room is a bed, unmade, a blanket hanging half off one side; it's framed by a nightstand and a closet door in the western wall.  The bedroom door to the east is, of course, closed.

A little white pamphlet lies on the floor near the door.

The floor is strewn with innumerable strata of dirty laundry, all of which is soft and comfortable under your paws.

(From down here, you can't see what's on the various raised surfaces around the room.)

[on the floor]

>get on shelves
You make your way up the shelves.  They're too short for your helmet to fit in, so the best you can do is hold onto them like a ladder.

The shelves stretch all the way up to the ceiling, but you can climb around them pretty easily.

On the shelves you can see a bunch of stuff.

[on the shelves]

>rules
Rules tracing now switched on. Type "rules off" to switch it off again, or "rules all" to include even rules which do not apply.

[on the shelves]

* * *

>climb bed
You get onto the bed.

On the bed you can see a pillow and a blanket.

>get on bed
You get onto the bed.

On the bed you can see a pillow and a blanket.

>x blanket
In the blanket are nothing.

>enter blanket
You get into the blanket.

It's your best friend, Purrl.  The two of you sure have had a lot of exciting adventures together!  You fondly reminisce about some of them, like the time you were trapped in the Chamber of Despair.

She catches you staring at her and scowls.

>x
(the bed)
On the bed are a pillow and a blanket.

* * *

>climb bed
You get onto the bed.

On the bed you can see a pillow and a blanket.

>look
Neon's bedroom (on the bed)
The lights are off and there are no windows, but the room is lit well enough by the cyan glow from the terminal on Neon's desk and the blinking LEDs on the strange machine in the corner.

The desk and an adjacent workbench run along the entire length of one wall.  shelves take up the opposite wall, except for a strange machine in the corner.  In the center of the room is a bed, unmade; on either side are a nightstand and a closet door.  The bedroom door is, of course, closed behind you.

The floor is strewn with innumerable strata of dirty laundry, which is soft and nice to stand on.

On the bed you can see a pillow and a blanket.

>pull blanket
You reel the blanket towards you with your little pest paws, and it slides away from the lump to reveal Purrl.
Purrl frowns and crosses her arms.  "Star Anise!!  What are you doing here!  I was taking a lovely nap, and then I had a nightmare that Star Anise woke me up, and then it wasn't a nightmare it was real!!"

What a fortuitous turn of events!  You practically vibrate with excitement.  "Oh!  Purrl!!!  I'm so glad to see you!!!!!  Listen we're trapped in the Chamber of Despair and we gotta make a daring but cool escape!!"

Purrl frowns harder.  You really don't understand how she does that with her eyebrows.  "No!  Go away!!  I just want to nap!"

You sigh.  It's a good thing you're so patient.  Sometimes Purrl just doesn't get it.  "I'm trying to go away!!  From this room!!  But I can't!!!"

Purrl taps her chin.  "So to escape Star Anise...  I have to help Star Anise escape."  She re-frowns and crosses her arms.  "Fine!!  But I'll do lovely help only."

"Yeah!!  Teaming up again let's go!!  Team Star Purrl Anise Fish Squad!!"

* * *

>look under bed
You find nothing of interest.

* * *

>climb bed
You get onto the bed.

On the bed you can see a pillow and a blanket.

>pull blanket
You reel the blanket towards you with your little pest paws, and it slides away from the lump to reveal Purrl.
Purrl frowns and crosses her arms.  "Star Anise!!  What are you doing here!  I was taking a lovely nap, and then I had a nightmare that Star Anise woke me up, and then it wasn't a nightmare it was real!!"

What a fortuitous turn of events!  You practically vibrate with excitement.  "Oh!  Purrl!!!  I'm so glad to see you!!!!!  Listen we're trapped in the Chamber of Despair and we gotta make a daring but cool escape!!"

* * *

"Yeah!!  Teaming up again let's go!!  Team Star Purrl Anise Fish Squad!!"

>show panel to purrl
You stand on your tippy toes, but you just can't reach the panel.  You AOOWWR in frustration.

>tell purrl about panel
You point up at the panel.  "I think that opens the door!!  Also it glows a lot and I wanna touch it.  But it's too tall up!"

"So???"

"So I need a boost!  Let me stand on your head!!"

Purrl puts her paws squarely on her hips.  "I'm not giving you any boots!  Find something else to stand on!!"

"Like what??  Everything in here is real big or real shirt!"  You stand on one of the dirty shirts on the floor.  "Look it doesn't make me any taller at all!  Not even one taller!"

"Ugh!!  Fine!!"

>climb purrl
Little is to be achieved by that.

>get on purrl
You mount Purrl.

>l
Neon's bedroom (on Purrl) (on the bed)
The lights are off and there are no windows, but the room is lit well enough by the cyan glow from the terminal on Neon's desk and the blinking LEDs on the strange machine in the corner.

The desk and an adjacent workbench run along the entire length of one wall.  shelves take up the opposite wall, except for a strange machine in the corner.  In the center of the room is a bed, unmade; beside it is a nightstand, then a closet door.  The bedroom door is, of course, closed behind you.

The floor is strewn with innumerable strata of dirty laundry, which is soft and nice to stand on.

On the bed you can see a pillow and a blanket (empty).

>purrl, down
You can't go that way.

>purrl, exit
Purrl has better things to do.

>get down
You dismount Purrl.

Neon's bedroom (on the bed)
The lights are off and there are no windows, but the room is lit well enough by the cyan glow from the terminal on Neon's desk and the blinking LEDs on the strange machine in the corner.

The desk and an adjacent workbench run along the entire length of one wall.  shelves take up the opposite wall, except for a strange machine in the corner.  In the center of the room is a bed, unmade; beside it is a nightstand, then a closet door.  The bedroom door is, of course, closed behind you.

The floor is strewn with innumerable strata of dirty laundry, which is soft and nice to stand on.

On the bed you can see Purrl, a pillow, and a blanket (empty).

>get on purrl
You mount Purrl.

* * *

>climb bed
You get onto the bed.

On the bed you can see a pillow and a blanket.

>x nightstand
On the nightstand is a lamp.

>touch lamp
You can't reach from on top of the bed.

>get on nightstand
You can't reach from on top of the bed.

>actions
Actions listing on.

>get on nightstand
[entering the nightstand]
You can't reach from on top of the bed.
[entering the nightstand - failed the basic accessibility rule]

* * *

>climb bed
You get onto the bed.

On the bed you can see a pillow and a blanket.

>get on nightstand
(the terminal, the terminal, false, false)You can't reach from on top of the terminal.

>get on nightstand
(the terminal, the terminal, false, false)You can't reach from on top of the terminal.

>look
Neon's bedroom (on the bed)
The lights are off and there are no windows, but the room is lit well enough by the cyan glow from the terminal on Neon's desk and the blinking LEDs on the strange machine in the corner.

The desk and an adjacent workbench run along the entire length of one wall.  shelves take up the opposite wall, except for a strange machine in the corner.  In the center of the room is a bed, unmade; on either side are a nightstand and a closet door.  The bedroom door is, of course, closed behind you.

The floor is strewn with innumerable strata of dirty laundry, which is soft and nice to stand on.

On the nightstand is a lamp.

A terminal sits here, radiating importance and cyan light.

On the bed you can see a pillow and a blanket.

>get on nightstand
(the terminal, the terminal, false, false)You can't reach from on top of the terminal.

>down
You would have to get off the bed first.

>exit
You get off the bed.

Neon's bedroom
The lights are off and there are no windows, but the room is lit well enough by the cyan glow from the terminal on Neon's desk and the blinking LEDs on the strange machine in the corner.

The desk and an adjacent workbench run along the entire length of one wall.  shelves take up the opposite wall, except for a strange machine in the corner.  In the center of the room is a bed, unmade; on either side are a nightstand and a closet door.  The bedroom door is, of course, closed behind you.

The floor is strewn with innumerable strata of dirty laundry, which is soft and nice to stand on.

On the bed is a blanket.

On the nightstand is nothing.

A terminal sits here, radiating importance and cyan light.

>get on nightstand
You get onto the nightstand.

On the nightstand you can see a lamp.

>x lamp
The lamp is currently switched off.

>turn lamp on
You switch the lamp on.

>x lamp
The lamp is currently switched on.

>take lamp
That's fixed in place.

>kick lamp
That's not a verb I recognize.

>push lamp
You bat at the lamp, but nothing happens.  Undeterred, you brace your helmet against it and give it a good hard shove.  It topples off the nightstand and onto the floor with a heavy thud.

>look
Neon's bedroom (on the nightstand)
The lights are off and there are no windows, but the room is lit well enough by the cyan glow from the terminal on Neon's desk and the blinking LEDs on the strange machine in the corner.

The desk and an adjacent workbench run along the entire length of one wall.  shelves take up the opposite wall, except for a strange machine in the corner.  In the center of the room is a bed, unmade; on either side are a nightstand and a closet door.  The bedroom door is, of course, closed behind you.

The floor is strewn with innumerable strata of dirty laundry, which is soft and nice to stand on.

On the bed are a pillow and a blanket.

A terminal sits here, radiating importance and cyan light.

You can also see a lamp here.

>look under bed
You peer under the bed.  Thanks to the lamplight, you can see a coin!  Score!  You love those!

You just barely reach it and pull it out.

>i
You are carrying:
  a coin

>look under bed
You peer under the bed, but don't see anything else of interest.

>take laundry
(the terminal, the terminal, false, false)You can't reach from on top of the terminal.

>take lamp
(the terminal, the terminal, false, false)You can't reach from on top of the terminal.

>l
Neon's bedroom (on the nightstand)
The lights are off and there are no windows, but the room is lit well enough by the cyan glow from the terminal on Neon's desk and the blinking LEDs on the strange machine in the corner.

The desk and an adjacent workbench run along the entire length of one wall.  shelves take up the opposite wall, except for a strange machine in the corner.  In the center of the room is a bed, unmade; on either side are a nightstand and a closet door.  The bedroom door is, of course, closed behind you.

The floor is strewn with innumerable strata of dirty laundry, which is soft and nice to stand on.

On the bed are a pillow and a blanket.

A terminal sits here, radiating importance and cyan light.

You can also see a lamp here.

* * *

>climb bed
You get onto the bed.

On the bed you can see a pillow and a blanket.

>look under bed
That's a little difficult when you're not on the floor.

>get on nightstand
(the terminal, the terminal, false, false)You can't reach from on top of the terminal.

>open closet
(the terminal, the terminal, false, false)You can't reach from on top of the terminal.

* * *

>open bedroom door
You open the bedroom door.

>e
You can't, since the bedroom door leads nowhere.

* * *

>x door
Which do you mean, the closet door or the bedroom door?

>bedroom
The door is an impenetrable metal monolith.  It has no doorknob, not that one would be especially helpful to you anyway.  Next to it is a glowing panel, much like the one Neon touched to open the door when she tossed you in here.

>x panel
This glowing rectangle is clearly the secret to your escape.  Also, it glows, and that makes you want to touch it very badly.

>touch panel
You stand on your tippy toes, but you just can't reach the panel.  You AOOWWR in frustration.

* * *

>x laundry
You see nothing special about the laundry.

>take blanket
You pick up the blanket.

Taken.

* * *

>x laundry
You see nothing special about the laundry.

>pull blanket
You tug on the blanket.  It slides off the bed and on top of you, bringing its contents with it.  A little flailing manages to kick it off of you, and you're greeted by a scowling face.

Purrl crosses her arms.  "Star Anise!!  What are you doing here!  I was taking a lovely nap, and then I had a nightmare that Star Anise woke me up, and then it wasn't a nightmare it was real!!  This is my sleep place that I found, go away!!"

You adopt an action pose, to convey how much action you're currently ready for.  "Oh!!!!!  Purrl!  I'm so glad to see you!!  Listen we're trapped in the Chamber of Despair and I've been trying to go away but I can't because of the trapped!  We gotta make a daringly cool escape!!  Do you have any explosives or maybe a cool gun."

"No!  Let me nap!!!"

"Yeah!!  A nap after we escape sounds great!!  Team Star Purrl Anise Fish Squad let's go!!"

[Your score has just gone up by five points.]

>look
Neon's bedroom
The lights are off and there are no windows, but the room is lit well enough by the cyan glow coming from Neon's desk and the blinking LEDs on the strange machine in the corner.

The desk and an adjacent workbench run along the entire length of one wall.  Some shelves take up the opposite wall, stopping short of the corner to make room for a strange machine.  In the center of the room is a bed; it's framed by a nightstand and a closet door in the western wall.  The bedroom door to the east is, of course, closed.

From down here, you can't see what's on the various raised surfaces around the room: the bed, nightstand, desk, workbench, and shelves.

The floor is strewn with innumerable strata of dirty laundry, all of which is soft and comfortable under your paws.  Purrl has found a nice shirt to wrap around herself.  Also down here is a blanket.

>take blanket
You pick up the blanket.

You pick up the blanket.

>look
Neon's bedroom
The lights are off and there are no windows, but the room is lit well enough by the cyan glow coming from Neon's desk and the blinking LEDs on the strange machine in the corner.

The desk and an adjacent workbench run along the entire length of one wall.  Some shelves take up the opposite wall, stopping short of the corner to make room for a strange machine.  In the center of the room is a bed; it's framed by a nightstand and a closet door in the western wall.  The bedroom door to the east is, of course, closed.

From down here, you can't see what's on the various raised surfaces around the room: the bed, nightstand, desk, workbench, and shelves.

The floor is strewn with innumerable strata of dirty laundry, all of which is soft and comfortable under your paws.  Purrl has found a nice shirt to wrap around herself.

>x shelves
On the shelves is nothing.

>x bed
On the bed is nothing.

>get on bed
You can't climb with your hands full.  "AOOWWRR!" you wail in despair.

>x bed
On the bed is nothing.

>drop blanket
Dropped.

>get on bed
Purrl gets onto the bed.

>x bed
On the bed are Purrl and a pillow.

>look
Neon's bedroom (on the bed)
The lights are off and there are no windows, but the room is lit well enough by the cyan glow coming from Neon's desk and the blinking LEDs on the strange machine in the corner.

The desk and an adjacent workbench run along the entire length of one wall.  Some shelves take up the opposite wall, stopping short of the corner to make room for a strange machine.  In the center of the room is a bed; it's framed by a nightstand and a closet door in the western wall.  The bedroom door to the east is, of course, closed.

From your vantage point atop the bed, you could see what's on the various other raised surfaces around the room (the nightstand, desk, workbench, and shelves), if you cared to take a look.

The floor is strewn with innumerable strata of dirty laundry, all of which is soft and comfortable under your paws.  Also down here is a blanket.
The blanket has been stripped from the bed, but the pillow is still here.

>climb nightstand
The nightstand is too far away!  You'll have to get closer.

>get on nightstand
The nightstand is too far away!  You'll have to get closer.

* * *

>pull blanket
You tug on the blanket.  It slides off the bed and on top of you, bringing its contents with it.  A little flailing manages to kick it off of you, and you're greeted by a scowling face.

Purrl crosses her arms.  "Star Anise!!  What are you doing here!  I was taking a lovely nap, and then I had a nightmare that Star Anise woke me up, and then it wasn't a nightmare it was real!!  This is my sleep place that I found, go away!!"

You adopt an action pose, to convey how much action you're currently ready for.  "Oh!!!!!  Purrl!  I'm so glad to see you!!  Listen we're trapped in the Chamber of Despair and I've been trying to go away but I can't because of the trapped!  We gotta make a daringly cool escape!!  Do you have any explosives or maybe a cool gun."

"No!  Let me nap!!!"

"Yeah!!  A nap after we escape sounds great!!  Team Star Purrl Anise Fish Squad let's go!!"

[Your score has just gone up by five points.]

[on the floor]

>touch blanket
It's too far, and you're fairly small.  You'll have to go over to the bed.

* * *

>show panel to purrl
You point up at the panel.  "I think that opens the door!!  Also it glows a lot and I wanna touch it.  But it's too tall up!  Gimme a boost!"

Purrl puts her paws squarely on her hips.  "I'm not giving you any boots!  Find something else to stand on!!"

"Like what??  Everything in here is real big or real shirt!"  You stand on one of the dirty shirts on the floor.  "Look it doesn't make me any taller at all!  Not even one taller."

"Mmmmnnmnnmm, I dunno."  Purrl licks her paw in a lovely manner.  "But okay.  But only if you don't bother M.O.R.S.E.L."

[Your score has just gone up by five points.]

>purrl, climb desk
Purrl has better things to do.

* * *

>get on purrl
You climb awkwardly on top of Purrl.

>push button
The machine beeps aggressively, and a red light next to the slot flashes on.

>take figurine
You pick up the Lily figurine.

>drop figurine
Dropped.

>look
Neon's bedroom (on Purrl)
The lights are off and there are no windows, but the room is lit well enough by the cyan glow coming from Neon's desk and the blinking LEDs on the tall machine in the corner.

The desk and an adjacent workbench run along the entire length of one wall.  Some shelves take up the opposite wall, stopping short of the corner to make room for a tall machine.  In the center of the room is a bed; it's framed by a nightstand and a closet door in the western wall.  The bedroom door to the east is, of course, closed.

From your vantage point atop Purrl, you could see what's on the various raised surfaces around the room (the bed, nightstand, desk, workbench, and shelves), if you cared to take a look.

A little white pamphlet lies on the floor near the door.

The floor is strewn with innumerable strata of dirty laundry, all of which is soft and comfortable under your paws.  Purrl has found a nice shirt to wrap around herself.  Also on the floor are a blanket, a glue stick, and a bag of glitter.

On Purrl you can see a Lily figurine.

* * *

>purrl, hi
There is no reply.

>purrl, down
Purrl furrows her brow.  "Don't tell me what to do, Star Anise!!"

>climb purrl
Little is to be achieved by that.

* * *

>climb purrl
"Don't step on me Star Anise!!"  Purrl grumbles and pushes you away.  You try to explain that you need to be taller, but she isn't swayed.

>get on purrl
You climb awkwardly on top of Purrl.

>purrl, get on bed
Purrl furrows her brow.  "Don't tell me what to do, Star Anise!!"

>look
Neon's bedroom (on Purrl)
The lights are off and there are no windows, but the room is lit well enough by the cyan glow from the terminal on Neon's desk and the blinking LEDs on the strange machine in the corner.

The desk and an adjacent workbench run along the entire length of one wall.  shelves take up the opposite wall, except for a strange machine in the corner.  In the center of the room is a bed, unmade; on either side are a nightstand and a closet door.  The bedroom door is, of course, closed behind you.

The floor is strewn with innumerable strata of dirty laundry, which is soft and nice to stand on.

On the bed is nothing.

On the nightstand is nothing.

A terminal sits here, radiating importance and cyan light.

You can also see a blanket here.

>rules
Rules tracing now switched on. Type "rules off" to switch it off again, or "rules all" to include even rules which do not apply.

>purrl, get on bed
[Rule "Smarter Parser advanced replace blank line rule" applies.]
[Rule "Numbered Disambiguation Choices strip closing parenthesis rule" applies.]
[Rule "Rule for deciding the concealed possessions of a platform" applies.]
[Rule "Rule for deciding the concealed possessions of a platform" applies.]
[Rule "Rule for deciding the concealed possessions of a platform" applies.]
[Rule "Rule for deciding the concealed possessions of a platform" applies.]
[Rule "Rule for deciding the concealed possessions of a platform" applies.]
[Rule "Rule for deciding the concealed possessions of a platform" applies.]
[Rule "Rule for deciding the concealed possessions of a platform" applies.]
[Rule "Rule for deciding the concealed possessions of a platform" applies.]
[Rule "Rule for deciding the concealed possessions of a platform" applies.]
[Rule "declare everything initially unmentioned rule" applies.]
[Rule "announce items from multiple object lists rule" applies.]
[Rule "set pronouns from items from multiple object lists rule" applies.]
[Rule "before stage rule" applies.]
[Rule "instead stage rule" applies.]
[Rule "Persuasion rule for asking Purrl to try doing something" applies.]
Purrl furrows her brow.  "Don't tell me what to do, Star Anise!!"

[Rule "A first turn sequence rule" applies.]
[Rule "every turn stage rule" applies.]
[Rule "A last turn sequence rule" applies.]
[Rule "notify score changes rule" applies.]

>rules all
[Rule "Smarter Parser advanced replace blank line rule" applies.]
[Rule "Numbered Disambiguation Choices strip closing parenthesis rule" applies.]
[Rule "declare everything initially unmentioned rule" applies.]
Rules tracing now switched to "all". Type "rules off" to switch it off again.

[Rule "Smarter Parser retrying input rule" does not apply (wrong context).]

* * *

>actions
[Rule "Numbered Disambiguation Choices reset disambiguation id when no numbers in command rule" does not apply (wrong context).]
[Rule "Smarter Parser advanced replace blank line rule" applies.]
[Rule "Numbered Disambiguation Choices strip closing parenthesis rule" applies.]
[Rule "declare everything initially unmentioned rule" applies.]
Actions listing on.

[Rule "Smarter Parser retrying input rule" does not apply (wrong context).]

* * *

>climb purrl
"Don't step on me Star Anise!!"  Purrl grumbles and pushes you away.  You try to explain that you need to be taller, but she isn't swayed.

>show panel to purrl
You point up at the panel.  "I think that opens the door!!  Also it glows a lot and I wanna touch it.  But it's too tall up!  Gimme a boost!"

Purrl puts her paws squarely on her hips.  "I'm not giving you any boots!  Find something else to stand on!!"

"Like what??  Everything in here is real big or real shirt!"  You stand on one of the dirty shirts on the floor.  "Look it doesn't make me any taller at all!  Not even one taller."

"Ugh!!  Fine."  Purrl licks her paw in a lovely manner.  "But only if you don't bother M.O.R.S.E.L."

>climb purrl
You climb awkwardly on top of Purrl.

>touch panel
You pap your paws against the panel.  It makes some delightful noises and flashes red for a moment.

* * *

>purrl, get on bed
Purrl furrows her brow.  "Don't tell me what to do, Star Anise!!"

>get on purrl
You climb awkwardly on top of Purrl.

>purrl, get on bed
Purrl snorts, but does as you ask.
Purrl gets onto the bed.

>test
>--> No test scripts exist for this game.

* * *

>purrl, get on bed
Purrl snorts, but does as you ask.
Purrl gets onto the bed.

>rules
Rules tracing now switched on. Type "rules off" to switch it off again, or "rules all" to include even rules which do not apply.

>purrl, get on bed
[Rule "Smarter Parser advanced replace blank line rule" applies.]
[Rule "Numbered Disambiguation Choices strip closing parenthesis rule" applies.]
[Rule "Rule for deciding the concealed possessions of a platform" applies.]
[Rule "Rule for deciding the concealed possessions of a platform" applies.]
[Rule "Rule for deciding the concealed possessions of a platform" applies.]
[Rule "Rule for deciding the concealed possessions of a platform" applies.]
[Rule "Rule for deciding the concealed possessions of a platform" applies.]
[Rule "Rule for deciding the concealed possessions of a platform" applies.]
[Rule "Rule for deciding the concealed possessions of a platform" applies.]
[Rule "Rule for deciding the concealed possessions of a platform" applies.]
[Rule "Rule for deciding the concealed possessions of a platform" applies.]
[Rule "declare everything initially unmentioned rule" applies.]
[Rule "announce items from multiple object lists rule" applies.]
[Rule "set pronouns from items from multiple object lists rule" applies.]
[Rule "before stage rule" applies.]
[Rule "instead stage rule" applies.]
[Rule "Persuasion rule for asking Purrl to try moving" applies.]
[Rule "Persuasion rule for asking Purrl to try doing something" applies.]
Purrl furrows her brow.  "Don't tell me what to do, Star Anise!!"

[Rule "A first turn sequence rule" applies.]
[Rule "every turn stage rule" applies.]
[Rule "A last turn sequence rule" applies.]
[Rule "notify score changes rule" applies.]

>x bed
[Rule "Smarter Parser advanced replace blank line rule" applies.]
[Rule "Numbered Disambiguation Choices strip closing parenthesis rule" applies.]
[Rule "Rule for deciding the concealed possessions of a platform" applies.]
[Rule "Rule for deciding the concealed possessions of a platform" applies.]
[Rule "Rule for deciding the concealed possessions of a platform" applies.]
[Rule "Small Kindnesses place the room in scope while looking rule" applies.]
[Rule "Rule for deciding the concealed possessions of a platform" applies.]
[Rule "Rule for deciding the concealed possessions of a platform" applies.]
[Rule "Rule for deciding the concealed possessions of a platform" applies.]
[Rule "Small Kindnesses place the room in scope while looking rule" applies.]
[Rule "Rule for deciding the concealed possessions of a platform" applies.]
[Rule "Rule for deciding the concealed possessions of a platform" applies.]
[Rule "Rule for deciding the concealed possessions of a platform" applies.]
[Rule "declare everything initially unmentioned rule" applies.]
[Rule "announce items from multiple object lists rule" applies.]
[Rule "set pronouns from items from multiple object lists rule" applies.]
[Rule "before stage rule" applies.]
[Rule "can't act in the dark rule" applies.]
[Rule "instead stage rule" applies.]
[Rule "investigate player's awareness before action rule" applies.]
[Rule "player aware of his own actions rule" applies.]
[Rule "check stage rule" applies.]
[Rule "carry out stage rule" applies.]
[Rule "Rule for deciding the concealed possessions of a platform" applies.]
[Rule "Rule for deciding the concealed possessions of a platform" applies.]
[Rule "Rule for deciding the concealed possessions of a platform" applies.]
[Rule "mark items as seen on examining rule" applies.]
[Rule "standard examining rule" applies.]
[Rule "examine directions rule" applies.]
[Rule "examine containers rule" applies.]
[Rule "examine supporters rule" applies.]
On the bed [Rule "Rule for deciding the concealed possessions of a platform" applies.]
is nothing.

[Rule "examine devices rule" applies.]
[Rule "examine undescribed things rule" applies.]
[Rule "after stage rule" applies.]
[Rule "investigate player's awareness after action rule" applies.]
[Rule "report stage rule" applies.]
[Rule "report other people examining rule" applies.]
[Rule "last specific action-processing rule" applies.]
[Rule "A first turn sequence rule" applies.]
[Rule "every turn stage rule" applies.]
[Rule "A last turn sequence rule" applies.]
[Rule "notify score changes rule" applies.]

* * *

>purrl, get on bed
Purrl snorts, but does as you ask.
Purrl gets onto the bed.

>touch panel
You stand on your tippy toes, but you just can't reach the panel.  You AOOWWR in frustration.

* * *

>get on purrl
"Don't step on me Star Anise!!"  Purrl grumbles and pushes you away.  You try to explain that you need to be taller, but she isn't swayed.

>show panel to purrl
You point up at the panel.  "I think that opens the door!!  Also it glows a lot and I wanna touch it.  But it's too tall up!  Gimme a boost!"

Purrl puts her paws squarely on her hips.  "I'm not giving you any boots!  Find something else to stand on!!"

"Like what??  Everything in here is real big or real shirt!"  You stand on one of the dirty shirts on the floor.  "Look it doesn't make me any taller at all!  Not even one taller."

"Ugh!!  Fine."  Purrl licks her paw in a lovely manner.  "But only if you don't bother M.O.R.S.E.L."

>climb on purrl
Little is to be achieved by that.

>get on purrl
You climb awkwardly on top of Purrl.

>actions
Actions listing on.

>climb on purrl
[climbing Purrl]
Little is to be achieved by that.
[climbing Purrl - failed the block climbing rule]

* * *

>pull blanket
Nothing obvious happens.

>search laundry
You toss some clothes in the air and generally have a great time.

Oh!  You spot something shiny under a jacket and dig it out.  It's a yellow star!

>i
Your paws are empty.

>look
Neon's bedroom
The lights are off and there are no windows, but the room is lit well enough by the cyan glow from the terminal on Neon's desk and the blinking LEDs on the strange machine in the corner.

The desk and an adjacent workbench run along the entire length of one wall.  shelves take up the opposite wall, except for a strange machine in the corner.  In the center of the room is a bed, unmade; on either side are a nightstand and a closet door.  The bedroom door is, of course, closed behind you.

The floor is strewn with innumerable strata of dirty laundry, which is soft and nice to stand on.

On the bed is nothing.

On the nightstand is nothing.

On the desk is nothing.

On the workbench is nothing.

You can also see a yellow star, Purrl, and a blanket here.

>x star
This star has too many points, but it's still a pretty good star.  It's metal and shiny and says "SHERIFF" in embossed letters.  All very good qualities.

>take stars
You pick up the yellow star.

Taken.

* * *

>pull blanket
Nothing obvious happens.

>get on purrl
"Don't step on me Star Anise!!"  Purrl grumbles and pushes you away.  You try to explain that you need to be taller, but she isn't swayed.  Maybe if you had a more concrete excuse?

>show panel to purrl
You point up at the panel.  "I think that opens the door!!  Also it glows a lot and I wanna touch it.  But it's too tall up!  Gimme a boost!"

Purrl puts her paws squarely on her hips.  "I'm not giving you any boots!  Find something else to stand on!!"

"Like what??  Everything in here is real big or real shirt!"  You stand on one of the dirty shirts on the floor.  "Look it doesn't make me any taller at all!  Not even one taller."

"Mmmmnnmnnmm, I dunno."  Purrl licks her paw in a lovely manner.  "But okay.  But only if you don't bother M.O.R.S.E.L."

[Your score has just gone up by five points.]

>get on purrl
You climb awkwardly on top of Purrl.

Purrl snorts.

>z
Time passes.

Purrl and M.O.R.S.E.L. exchange annoyed looks.

>z
Time passes.

Purrl snorts.

>z
Time passes.

Purrl grumbles.

>z
Time passes.

Purrl sighs dramatically.

>z
Time passes.

"Mewo!!  That's enough, Star Anise!  Get off of me!!"  Purrl shakes her head back and forth, sending you tumbling to the floor.

Neon's bedroom
The lights are off and there are no windows, but the room is lit well enough by the cyan glow coming from Neon's desk and the blinking LEDs on the tall machine in the corner.

The desk and an adjacent workbench run along the entire length of one wall.  Some shelves take up the opposite wall, stopping short of the corner to make room for a tall machine.  In the center of the room is a bed; it's framed by a nightstand and a closet door in the western wall.  The bedroom door to the east is, of course, closed.

From down here, you can't see what's on the various raised surfaces around the room: the bed, nightstand, desk, workbench, and shelves.

A little white pamphlet lies on the floor near the door.

The floor is strewn with innumerable strata of dirty laundry, all of which is soft and comfortable under your paws.  Purrl has found a nice shirt to wrap around herself.  Also on the floor are a blanket, a glue stick, and a bag of glitter.

>read pamphlet
Welcome to interactive fiction!  I see you've already got the basics down.

As you can see, the game understands basic English instructions like READ THE PAMPHLET, as well as some slightly fancier constructs like TAKE THE COOKIE FROM THE JAR, but that's as complex as it gets.

Tip: X is short for EXAMINE!

You flip through the rest of the pamphlet, which contains detailed instructions and a complete walkthrough, but there aren't any pictures!  Not one!  Worthless.

>help
Try typing LOOK for a description of your surroundings. Any directions indicate exits which you can use by typing WEST (or W). Some of the objects mentioned in the description might be worth a closer look with a command like EXAMINE GLUE STICK. You can also TAKE or DROP some things, type INVENTORY to see a list of what you're carrying already, OPEN or CLOSE containers or doors, and so on.

To stop these messages entirely, type NOVICE OFF.

>look
Neon's bedroom
The lights are off and there are no windows, but the room is lit well enough by the cyan glow coming from Neon's desk and the blinking LEDs on the tall machine in the corner.

The desk and an adjacent workbench run along the entire length of one wall.  Some shelves take up the opposite wall, stopping short of the corner to make room for a tall machine.  In the center of the room is a bed; it's framed by a nightstand and a closet door in the western wall.  The bedroom door to the east is, of course, closed.

From down here, you can't see what's on the various raised surfaces around the room: the bed, nightstand, desk, workbench, and shelves.

The floor is strewn with innumerable strata of dirty laundry, all of which is soft and comfortable under your paws.  Purrl has found a nice shirt to wrap around herself.  Also on the floor are a blanket, a pamphlet, a glue stick, and a bag of glitter.

Purrl gently pokes the blanket.

* * *

>look
Neon's bedroom
The lights are off and there are no windows, but the room is lit well enough by the cyan glow from the terminal on Neon's desk and the blinking LEDs on the strange machine in the corner.

The desk and an adjacent workbench run along the entire length of one wall.  shelves take up the opposite wall, except for a strange machine in the corner.  In the center of the room is a bed, unmade; on either side are a nightstand and a closet door.  The bedroom door is, of course, closed behind you.

The floor is strewn with innumerable strata of dirty laundry, which is soft and nice to stand on.

On the bed is nothing.

On the nightstand is nothing.

On the desk is nothing.

On the workbench is nothing.

On the shelves is nothing.

On the floorare Purrl and a blanket.

>x me
You are Star Anise, coolest of the lunekos.

>get on desk
Purrl gets onto the desk.

>look
Neon's bedroom (on the desk)
The lights are off and there are no windows, but the room is lit well enough by the cyan glow from the terminal on Neon's desk and the blinking LEDs on the strange machine in the corner.

The desk and an adjacent workbench run along the entire length of one wall.  shelves take up the opposite wall, except for a strange machine in the corner.  In the center of the room is a bed, unmade; on either side are a nightstand and a closet door.  The bedroom door is, of course, closed behind you.

The floor is strewn with innumerable strata of dirty laundry, which is soft and nice to stand on.

On the bed is a pillow.

On the nightstand is a lamp.

On the workbench are a mug, some construction paper, and some scissors.

On the shelves are an award and a tiny jar of paint.

On the flooris a blanket.

On the desk you can see Purrl and a terminal.

* * *

>show doorknob to purrl
You strain, but you just can't reach the doorknob from here.

>show panel to purrl
You point up at the panel.  "I think that opens the door!!  Also it glows a lot and I wanna touch it.  But it's too tall up!  Gimme a boost!"

Purrl puts her paws squarely on her hips.  "I'm not giving you any boots!  Find something else to stand on!!"

"Like what??  Everything in here is real big or real shirt!"  You stand on one of the dirty shirts on the floor.  "Look it doesn't make me any taller at all!  Not even one taller."

"Mmmmnnmnnmm, I dunno."  Purrl licks her paw in a lovely manner.  "But okay.  But only if you don't bother M.O.R.S.E.L."

[Your score has just gone up by five points.]

>undo
Neon's bedroom
[Previous turn undone.]

>show button to purrl
(first taking the red button)
That seems to be a part of the tall machine.

* * *

>show button to purrl
You point frantically at the red button.  "Look look at this look!!  I think I can reach it if you gimme a boost!!"

"What are you talking about Star Anise!!  How does that help you go away!!"

You freeze like a deer in headlights.  "Because I wanna touch it?"

* * *

>talk to purrl
There is no reply.

>x button
This almost definitely does something good.

>touch button
You stand on your tippy toes, but you just can't reach the red button.  You AOOWWR in frustration.

>climb on bed
Purrl gets onto the bed.

* * *

>climb nightstand
You get onto the nightstand.

>rules
Rules tracing now switched on. Type "rules off" to switch it off again, or "rules all" to include even rules which do not apply.

* * *

>tell purrl about panel
You point up at the panel.  "I think that opens the door!!  Also it glows a lot and I wanna touch it.  But it's too tall up!  Gimme a boost!"

Purrl puts her paws squarely on her hips.  "I'm not giving you any boots!  Find something else to stand on!!"

"Like what??  Everything in here is real big or real shirt!"  You stand on one of the dirty shirts on the floor.  "Look it doesn't make me any taller at all!  Not even one taller!!  I can't escape like this!"

"Mmmmnnmnnmmnnnn.  I dunno."  Purrl licks her paw in a lovely manner.  "But okay.  But only if you don't bother M.O.R.S.E.L."

[Your score has just gone up by five points.]

* * *

>say hello
(to Purrl)
Purrl folds her arms and looks off in a different direction.

Purrl gently pokes yourself.

>actions
Actions listing on.

>say hello
(to Purrl)
[answering Purrl that "hello"]
Purrl folds her arms and looks off in a different direction.
[answering Purrl that "hello" - failed]

>hello
That's not a verb I recognize.

>get on workbench
[entering the workbench]
You get onto the workbench.

A broad flat plain stretches out in front of you.

On the workbench you can see a mug, a construction paper, some scissors, and a laser engraver.

[entering the workbench - succeeded]

>actions off
Actions listing off.

>take laser
You pick up the laser engraver.

Purrl yawns.

>use laser engraver
You'll have to try a more specific verb than use.

>write on workbench with engraver
The laser engraver beeps, and a soothing voice says: "Please be careful.  Organic material detected."

* * *

>x purrl
It's your best friend, Purrl!  The two of you sure have had a lot of exciting adventures together!  You fondly reminisce about some of them, like the time you were trapped in the Chamber of Despair.

She catches you staring at her and scowls.  M.O.R.S.E.L., the fish swimming around inside her helmet who likes you just as much as Purrl does, also seems to scowl.

* * *

>show machine to purrl
(first taking the tall machine)
You make an impressive effort, but that's far too heavy for you to carry.

[on the floor]

>show button to purrl
You point frantically at the red button.  "Look look at this look!!  I think I can reach it if you gimme a boost!!"

Purrl stomps her foot defiantly and definitively.  "What are you talking about Star Anise!!  How does that help you go away!"

You freeze like a deer in headlights.  "Because of I wanna touch it?"

"No!!"

[on the floor]

>talk purrl
I didn't understand that sentence.

[on the floor]

>talk to purrl
Purrl folds her arms and looks off in a different direction.

[on the floor]

>take purrl
I don't suppose Purrl would care for that.

[on the floor]

* * *

>x panel
This glowing rectangle is clearly the secret to your escape.  Also, it glows, and that makes you want to touch it very badly.

>touch panel
You stand on your tippy toes, but you just can't reach the glowing panel.  You AOOWWR in frustration.

* * *

>touch panel
You stand on your tippy toes, but you just can't reach the glowing panel.  You AOOWWR in frustration.

[on the floor]

>take blanket
You pick up the blanket.

Taken.

* * *

>touch panel
You stand on your tippy toes, but you just can't reach the glowing panel.  You AOOWWR in frustration.

[on the floor]

>pull blanket
You tug on the blanket.  It slides off the bed and on top of you, bringing its contents with it.  A little flailing manages to kick it off of you, and you're greeted by a scowling face.

Purrl crosses her arms.  "Star Anise!!  What are you doing here!  I was taking a lovely nap, and then I had a nightmare that Star Anise woke me up, and then it wasn't a nightmare it was real!!  This is my sleep place that I found, go away!!"

You adopt an action pose, to convey how much action you're currently ready for.  "Oh!!!!!  Purrl!  I'm so glad to see you!!  Listen we're trapped in the Chamber of Despair and I've been trying to go away but I can't because of the trapped!  We gotta make a daringly cool escape!!  Do you have any explosives or maybe a cool gun."

"No!  Let me nap!!!"

"Yeah!!  A nap after we escape sounds great!!  Team Star Purrl Anise Fish Squad let's go!!"

[Your score has just gone up by five points.]

[on the floor]

>tell purrl about panel
You point up at the panel.  "I think that opens the door!!  Also it glows a lot and I wanna touch it.  But it's too tall up!  Gimme a boost!"

Purrl puts her paws squarely on her hips.  "I'm not giving you any boots!  Find something else to stand on!!"

"Like what??  Everything in here is real big or real shirt!"  You stand on one of the dirty shirts on the floor.  "Look it doesn't make me any taller at all!  Not even one taller!!  I can't escape like this!"

"Mmmmnnmnnmmnnnn.  I dunno."  Purrl licks her paw in a lovely manner.  "But okay.  But only if you don't bother M.O.R.S.E.L."

[Your score has just gone up by five points.]

[on the floor]

>get on purrl
Purrl reluctantly leans down for you, and you clamber awkwardly on top of her helmet.

[on Purrl]

>touch panel
You try this a couple times, but to no avail.  "It didn't work!!  Let me out you dumb lights thing!!"

Purrl frowns up at your butt.  "Can I go do more nap now?"

"No!!!  I have a new idea!!"  You hop down off Purrl's helmet and kick some laundry around, making a clearing on the floor.  "It's time to open Star Anise shop!!  It's the only way!!!!"

"I don't care about Star Anise shop!!!!"  Purrl takes out her frustrations by helping you kick laundry.

[Your score has just gone up by ten points.]

[on the floor]

>get on purrl
Purrl reluctantly leans down for you, and you clamber awkwardly on top of her helmet.

[on Purrl]

>touch panel
You pap your paws against the panel.  It makes some delightful noises and flashes red for a moment.

Purrl grumbles.

[on Purrl]

* * *

>x bed
This big cat bed is for the big cat.  Sometimes she shares it with you, but only if she's asleep already.

You can't see what's on the bed from here, though hanging over the edge is a blanket.

[on the floor]

>climb bed
You get onto the bed.

The blanket strewn haphazardly across the bed bears a circuit pattern that matches the pillow, as well as a conspicuous lump in the middle.

>x
What do you want to examine?

>look
Neon's bedroom (on the bed)
The lights are off and there are no windows, but the room is lit well enough by the cyan glow from the terminal on Neon's desk and the blinking LEDs on the strange machine in the corner.

The desk and an adjacent workbench run along the entire length of one wall.  shelves take up the opposite wall, except for a strange machine in the corner.  In the center of the room is a bed, unmade; on either side are a nightstand and a closet door.  The bedroom door is, of course, closed behind you.

The floor is strewn with innumerable strata of dirty laundry, which is soft and nice to stand on.

On the bed you can see nothing.

>x pillow
You can't see any such thing.

* * *

>climb bed
You get onto the bed.

The blanket strewn haphazardly across the bed bears a circuit pattern that matches the pillow, as well as a conspicuous lump in the middle.

>sit on lump
You sit down on the lump, which is even less comfortable than you thought it would be.  It immediately makes an annoyed meow and tosses both you and the blanket aside, revealing an annoyed luneko.

Purrl crosses her arms.  "Star Anise!!  What are you doing here!  I was taking a lovely nap, and then I had a nightmare that Star Anise woke me up, and then it wasn't a nightmare it was real!!  This is my sleep place that I found, go away!!"

You adopt an action pose, to convey how much action you're currently ready for.  "Oh!!!!!  Purrl!  I'm so glad to see you!!  Listen we're trapped in the Chamber of Despair and I've been trying to go away but I can't because of the trapped!  We gotta make a daringly cool escape!!  Do you have any explosives or maybe a cool gun."

"No!  Let me nap!!!"

"Yeah!!  A nap after we escape sounds great!!  Team Star Purrl Anise Fish Squad let's go!!"

[Your score has just gone up by five points.]

>undo
Neon's bedroom
[Previous turn undone.]

>poke lump
The lump grumbles.

>pap lump
Nothing obvious happens.

>take lump
That seems to be a part of the blanket.

>restart
Are you sure you want to restart?

>y
You struggle and cry for help, but your captor ignores your feeble pleas.  They toss you, like garbage, into the darkness.  The heavy gate closes and locks behind you, sealing your fate.  Their maniacal laughter echoes into the distance, leaving you alone with your thoughts.

You are trapped.  Trapped...  in the Chamber of Despair.

Star Anise Chronicles: Escape from the Chamber of Despair
An Interactive Fiction by Eevee
Release 1 / Serial number 191216 / Inform 7 build 6M62 (I6/v6.33 lib 6/12N) SD

Neon's bedroom
The lights are off and there are no windows, but the room is lit well enough by the cyan glow coming from Neon's desk and the blinking LEDs on the tall machine in the corner.

The desk and an adjacent workbench run along the entire length of one wall.  Some shelves take up the opposite wall, stopping short of the corner to make room for a tall machine.  In the center of the room is a bed, unmade, a blanket hanging half off one side; it's framed by a nightstand and a closet door in the western wall.  The bedroom door to the east is, of course, closed.

From down here, you can't see what's on the various raised surfaces around the room: the bed, nightstand, desk, workbench, and shelves.

A little white pamphlet lies on the floor near the door.

The floor is strewn with innumerable strata of dirty laundry, all of which is soft and comfortable under your paws.  Also on the floor are a glue stick and a bag of glitter.

>take glue stick
You pick up the glue stick.

* * *

>x bed
This big cat bed is for the big cat.  Sometimes she shares it with you, but only if she's asleep already.

You can't see what's on the bed from here, though hanging over the edge is a blanket.

[on the floor]

>x shelves
You see nothing special about the shelves.

You can't see what's on the shelves from here.

[on the floor]

>get on shelves
You make your way up the shelves.  They're too short for your helmet to fit in, so the best you can do is hold onto them like a ladder.

[on the shelves]

>x shelves
On the shelves is a bunch of stuff.

[on the shelves]

>look
Neon's bedroom (on the shelves)
The lights are off and there are no windows, but the room is lit well enough by the cyan glow coming from Neon's desk and the blinking LEDs on the tall machine in the corner.

The desk, with a drawer underneath, and an adjacent workbench run along the entire length of one wall.  Some shelves take up the opposite wall, stopping short of the corner to make room for a tall machine.  In the center of the room is a bed, unmade, a blanket hanging half off one side; it's framed by a nightstand and a closet door in the western wall.  The bedroom door to the east is, of course, closed.

A little white pamphlet lies on the floor near the door.

The floor is strewn with innumerable strata of dirty laundry, all of which is soft and comfortable under your paws.

(From your vantage point atop the shelves, you can get a better look at the various other raised surfaces around the room.)

These shelves run all the way to the ceiling and are absolutely jam-packed with a whole bunch of stuff.

[on the shelves]

>down
You hop down off of the shelves.

Neon's bedroom
The lights are off and there are no windows, but the room is lit well enough by the cyan glow coming from Neon's desk and the blinking LEDs on the tall machine in the corner.

The desk, with a drawer underneath, and an adjacent workbench run along the entire length of one wall.  Some shelves take up the opposite wall, stopping short of the corner to make room for a tall machine.  In the center of the room is a bed, unmade, a blanket hanging half off one side; it's framed by a nightstand and a closet door in the western wall.  The bedroom door to the east is, of course, closed.

A little white pamphlet lies on the floor near the door.

The floor is strewn with innumerable strata of dirty laundry, all of which is soft and comfortable under your paws.

(From down here, you can't see what's on the various raised surfaces around the room.)

[on the floor]

>down
You crouch down real low, to make it harder for enemies to spot you, which is foiled somewhat by the giant sparkling helmet you're wearing.

[on the floor]

>get on bed
You get onto the bed.

The blanket laying haphazardly across the bed bears a circuit pattern that matches the pillow, as well as a conspicuous lump in the middle.

[on the bed]

>x me
You are Star Anise, a luneko and a cool guy who love to party.  The stars inside your helmet twinkle extra-hard as you think about how much you love to party.

[on the bed]

>get on nightstand
You get onto the nightstand.

This little platform is the perfect size for you!

On the nightstand you can see some scissors and a lamp.

[on the nightstand]

>down
You hop down off of the nightstand.

Neon's bedroom
The lights are off and there are no windows, but the room is lit well enough by the cyan glow coming from Neon's desk and the blinking LEDs on the tall machine in the corner.

The desk, with a drawer underneath, and an adjacent workbench run along the entire length of one wall.  Some shelves take up the opposite wall, stopping short of the corner to make room for a tall machine.  In the center of the room is a bed, unmade, a blanket hanging half off one side; it's framed by a nightstand and a closet door in the western wall.  The bedroom door to the east is, of course, closed.

A little white pamphlet lies on the floor near the door.

The floor is strewn with innumerable strata of dirty laundry, all of which is soft and comfortable under your paws.

(From down here, you can't see what's on the various raised surfaces around the room.)

[on the floor]

>get on bed
You get onto the bed.

The blanket laying haphazardly across the bed bears a circuit pattern that matches the pillow, as well as a conspicuous lump in the middle.

[on the bed]

* * *

>x terminal
You can't see the terminal any more.

>look under bed
You peer under the bed.  It's too dark to see anything.

>climb bed
You get onto the bed.

On the bed you can see a pillow and a blanket.

>look
Neon's bedroom (on the bed)
The lights are off and there are no windows, but the room is lit well enough by the cyan glow from the terminal on Neon's desk and the blinking LEDs on the strange machine in the corner.

The desk and an adjacent workbench run along the entire length of one wall.  shelves take up the opposite wall, except for a strange machine in the corner.  In the center of the room is a bed, unmade; on either side are a nightstand and a closet door.  The bedroom door is, of course, closed behind you.

The floor is strewn with innumerable strata of dirty laundry, which is soft and nice to stand on.

On the nightstand is a lamp.

A terminal sits here, radiating importance and cyan light.

On the bed you can see a pillow and a blanket.

>x nightstand
On the nightstand is a lamp.

>get on nightstand
You can't reach from on top of the bed.

* * *

>x terminal
You can't see the terminal any more.

>pull blanket
(making lump invisible)
You tug on the blanket.  It slides off the bed and on top of you, bringing its contents with it.  A little flailing manages to kick it off of you, and you're greeted by a scowling face.

Purrl crosses her arms.  "Star Anise!!  What are you doing here!  I was taking a lovely nap, and then I had a nightmare that Star Anise woke me up, and then it wasn't a nightmare it was real!!  This is my sleep place that I found, go away!!"

You adopt an action pose, to convey how much action you're currently ready for.  "Oh!!!!!  Purrl!  I'm so glad to see you!!  Listen we're trapped in the Chamber of Despair and I've been trying to go away but I can't because of the trapped!  We gotta make a daringly cool escape!!  Do you have any explosives or maybe a cool gun."

"No!  Let me nap!!!"

"Yeah!!  A nap after we escape sounds great!!  Team Star Purrl Anise Fish Squad let's go!!"

>climb bed
Purrl gets onto the bed.

>down
You get off the bed.

Neon's bedroom
The lights are off and there are no windows, but the room is lit well enough by the cyan glow from the terminal on Neon's desk and the blinking LEDs on the strange machine in the corner.

The desk and an adjacent workbench run along the entire length of one wall.  shelves take up the opposite wall, except for a strange machine in the corner.  In the center of the room is a bed, unmade; on either side are a nightstand and a closet door.  The bedroom door is, of course, closed behind you.

The floor is strewn with innumerable strata of dirty laundry, which is soft and nice to stand on.

On the bed is nothing.

On the nightstand is nothing.

A terminal sits here, radiating importance and cyan light.

You can also see a blanket here.

Purrl gets off the bed.

>use machine
You switch the strange machine on.

>x me
The last time you saw yourself, you was right here.

>x panel
The last time you saw the glowing panel, it was .

>scope
1: Purrl (673995)
2: yourself (673515)
3: a blanket (673675)
4: a closet door (674059)
5: some laundry (673547)
6: a bedroom door (673579)
7: a glowing panel (673931)
8: a bed (673611)
9: a nightstand (673707)
10: a desk (673771)
11: a workbench (673835)
12: some shelves (673867)
13: a strange machine (673899)

>x bed
The last time you saw the bed, it was right here.

* * *

>x terminal
You can't see the terminal any more.

>x bed
The last time you saw the bed, it was right here.

>actions
Actions listing on.

>x bed
[remembering the bed]
The last time you saw the bed, it was right here.
[remembering the bed - succeeded]

>inspect bed
[remembering the bed]
The last time you saw the bed, it was right here.
[remembering the bed - succeeded]

* * *

>aowr
AOOOWWWRRRR!!

>meow
AOOOWWWRRRR!!

* * *

>take laundry
You pick up a shirt.  It's a few sizes too big for you, so you put it back down.

>x door
Which do you mean, the closet door or the bedroom door?

* * *

>touch panel
You stand on your tippy toes, but you just can't reach the panel.  You AOOWWR in frustration.

>aoowwr
That's not a verb I recognize.

* * *

>get under blanket
You can't see any such thing.

>x blanket
In the blanket is nothing.

>look under blanket
You find nothing of interest.

* * *

>touch blanket
You knead at the wonderfully soft fabric.  It reminds you of all the good times, kneading on blankets.

You feel nothing unexpected.

>x blanket
The blanket is soft, fuzzy, warm, and much bigger than you.  Everything you ever wanted.  Not just in a blanket, but in general.

>x lump
You can't see any such thing.

>climb blanket
Little is to be achieved by that.

>jump
You jump on the spot.

>climb bed
You get onto the bed.

The blanket strewn haphazardly across the bed bears a circuit pattern, as well as a conspicuous lump in the middle.

On the bed you can also see a pillow.

>look
Neon's bedroom (on the bed)
The lights are off and there are no windows, but the room is lit well enough by the cyan glow from the terminal on Neon's desk and the blinking LEDs on the strange machine in the corner.

The desk and an adjacent workbench run along the entire length of one wall.  shelves take up the opposite wall, except for a strange machine in the corner.  In the center of the room is a bed, unmade; on either side are a nightstand and a closet door.  The bedroom door is, of course, closed behind you.

The floor is strewn with innumerable strata of dirty laundry, which is soft and nice to stand on.

The blanket strewn haphazardly across the bed bears a circuit pattern, as well as a conspicuous lump in the middle.

On the nightstand is a lamp.

A terminal sits here, radiating importance and cyan light.

On the bed you can see a pillow.

>x lump
You can't see any such thing.

>scope
1: a closet door (610924)
2: some laundry (610412)
3: a bedroom door (610444)
4: a glowing panel (610796)
5: a bed (610476)
6: yourself (610380)
7: a pillow (610508)
8: a blanket (610540)
9: a nightstand (610572)
10: a lamp (610604)
11: a desk (610636)
12: a terminal (610668)
13: a workbench (610700)
14: some shelves (610732)
15: a strange machine (610764)

>x lamp
The lamp is currently switched off.

>touch lamp
The lamp is too far away!  You'll have to get closer.

>go on nightstand
You can't see any such thing.

>get on nightstand
(getting off the bed)
You get onto the nightstand.

On the nightstand you can see a lamp.

>x lamp
The lamp is currently switched off.

>get on bed
(getting off the nightstand)
You get onto the bed.

The blanket strewn haphazardly across the bed bears a circuit pattern, as well as a conspicuous lump in the middle.

On the bed you can also see a pillow.

>x lump
You can't see any such thing.

>showme lump
lump - thing
location: part of the blanket on the bed in Neon's bedroom
singular-named, improper-named; unlit, inedible, portable
list grouping key: none
printed name: "lump"
printed plural name: none
indefinite article: none
description: "Something about the large sphericalness of this lump is oddly familiar."
initial appearance: none

>x lump
You can't see any such thing.

>rules
Rules tracing now switched on. Type "rules off" to switch it off again, or "rules all" to include even rules which do not apply.

>x lump
[Rule "Rule for deciding the concealed possessions of a platform" applies.]
[Rule "Rule for deciding the concealed possessions of a platform" applies.]
[Rule "Rule for deciding the concealed possessions of a platform" applies.]
[Rule "Rule for deciding the concealed possessions of the blanket" applies.]
[Rule "Rule for deciding the concealed possessions of a platform" applies.]
[Rule "Rule for deciding the concealed possessions of a platform" applies.]
You can't see any such thing.

* * *

>x blanket
The blanket is soft, fuzzy, warm, and much bigger than you.  Everything you ever wanted.  Not just in a blanket, but in general.

>x lump
(making lump invisible)You can't see any such thing.

>climb bed
(making lump invisible)
You get onto the bed.

The blanket strewn haphazardly across the bed bears a circuit pattern, as well as a conspicuous lump in the middle.

On the bed you can also see a pillow.

>x blanket
The blanket is soft, fuzzy, warm, and much bigger than you.  Everything you ever wanted.  Not just in a blanket, but in general.

A conspicuous lump rises out of the middle of it.

>x lump
Something about the large sphericalness of this lump is oddly familiar.

>touch lump
The lump grumbles.

>hit lump
Violence isn't the answer to this one.

>look under lump
You find nothing of interest.

>look under blanket
You reel the blanket towards you with your little pest paws, and it slides away from the lump to reveal Purrl.  She hops to her feet, bewildered, but her expression darkens when she notices you.
Purrl crosses her arms.  "Star Anise!!  What are you doing here!  I was taking a lovely nap, and then I had a nightmare that Star Anise woke me up, and then it wasn't a nightmare it was real!!  This is my sleep place that I found, go away!!"

You adopt an action pose, to convey how much action you're currently ready for.  "Oh!!!!!  Purrl!  I'm so glad to see you!!  Listen we're trapped in the Chamber of Despair and I've been trying to go away but I can't because of the trapped!  We gotta make a daringly cool escape!!  Do you have any explosives or maybe a cool gun."

"No!  Let me nap!!!"

"Yeah!!  A nap after we escape sounds great!!  Team Star Purrl Anise Fish Squad let's go!!"

>x purrl
It's your best friend, Purrl!  The two of you sure have had a lot of exciting adventures together!  You fondly reminisce about some of them, like the time you were trapped in the Chamber of Despair.

She catches you staring at her and scowls.

>show panel to purrl
You stand on your tippy toes, but you just can't reach the panel.  You AOOWWR in frustration.

* * *

>x blanket
The blanket is soft, fuzzy, warm, and much bigger than you.  Everything you ever wanted.  Not just in a blanket, but in general.

>climb bed
(making lump invisible)
You get onto the bed.

The blanket strewn haphazardly across the bed bears a circuit pattern, as well as a conspicuous lump in the middle.

On the bed you can also see a pillow.

* * *

>x blanket
The blanket is soft, fuzzy, warm, and much bigger than you.  Everything you ever wanted.  Not just in a blanket, but in general.

A conspicuous lump rises out of the middle of it.

>x lump
You can't see any such thing.

>scope
1: a closet door (611692)
2: some laundry (611180)
3: a bedroom door (611212)
4: a glowing panel (611564)
5: a bed (611244)
6: yourself (611148)
7: a pillow (611276)
8: a blanket (611308)
9: a nightstand (611340)
10: a lamp (611372)
11: a desk (611404)
12: a terminal (611436)
13: a workbench (611468)
14: some shelves (611500)
15: a strange machine (611532)

* * *

>x lump
You can't see any such thing.

>x blanket
The blanket is soft, fuzzy, warm, and much bigger than you.  Everything you ever wanted.  Not just in a blanket, but in general.

>climb blanket
You get onto the bed.

The blanket strewn haphazardly across the bed bears a circuit pattern, as well as a conspicuous lump in the middle.

On the bed you can also see a pillow.

>x blanket
The blanket is soft, fuzzy, warm, and much bigger than you.  Everything you ever wanted.  Not just in a blanket, but in general.

A conspicuous lump rises out of the middle of it.

* * *

>test shop
(Testing.)

[on the floor] >[1] pull blanket
You tug on the blanket.  It slides off the bed and on top of you, bringing its contents with it.  A little flailing manages to kick it off of you, and you're greeted by a scowling face.

Purrl crosses her arms.  "Star Anise!!  What are you doing here!  I was taking a lovely nap, and then I had a nightmare that Star Anise woke me up, and then it wasn't a nightmare it was real!!  This is my sleep place that I found, go away!!"

You adopt an action pose, to convey how much action you're currently ready for.  "Oh!!!!!  Purrl!  I'm so glad to see you!!  Listen we're trapped in the Chamber of Despair and I've been trying to go away but I can't because of the trapped!  We gotta make a daringly cool escape!!  Do you have any explosives or maybe a cool gun."

"No!  Let me nap!!!"

"Yeah!!  A nap after we escape sounds great!!  Team Star Purrl Anise Fish Squad let's go!!"

[Your score has just gone up by five points.]

[on the floor] >[2] show panel to purrl

You point up at the panel.  "I think that opens the door!!  Also it glows a lot and I wanna touch it.  But it's too tall up!  Gimme a boost!"

Purrl puts her paws squarely on her hips.  "I'm not giving you any boots!  Find something else to stand on!!"

"Like what??  Everything in here is real big or real shirt!"  You stand on one of the dirty shirts on the floor.  "Look it doesn't make me any taller at all!  Not even one taller!!  I can't escape like this!"

"Mmmmnnmnnmmnnnn.  I dunno."  Purrl licks her paw in a lovely manner.  "But okay.  But only if you don't bother M.O.R.S.E.L."

[Your score has just gone up by five points.]

[on the floor] >[3] climb purrl

Purrl reluctantly leans down for you, and you clamber awkwardly on top of her helmet.

[on Purrl] >[4] touch panel
You pap your paws against the panel.  It makes some delightful noises and flashes red for a moment.

You try this a couple times, but to no avail.  "It didn't work!!  Let me out you dumb lights thing!!"

Purrl frowns up at your butt.  "Can I go do more nap now?"

"No!!!  I have a new idea!!"  You hop down off Purrl's helmet and kick some laundry around, making a clearing on the floor.  "It's time to open Star Anise shop!!  It's the only way!!!!"

"I don't care about Star Anise shop!!!!"  Purrl takes out her frustrations by helping you kick laundry.

[Your score has just gone up by ten points.]

[on the floor]

>x shop
It's the latest location for Star Anise Shop, the best shop for buying things from Star Anise!

So far, though, it's nothing more than a clear space on the floor.
It still needs:
- something big with an opening, to act as a stall
- a name painted on the stall
- stars to decorate it
- at least three kinds of high quality merchandise
- a customer

>look
Neon's bedroom
The lights are off and there are no windows, but the room is lit well enough by the cyan glow from the terminal on Neon's desk and the blinking LEDs on the strange machine in the corner.

The desk and an adjacent workbench run along the entire length of one wall.  shelves take up the opposite wall, except for a strange machine in the corner.  In the center of the room is a bed, unmade; on either side are a nightstand and a closet door.  The bedroom door is, of course, closed behind you.

Your new shop is taking shape, though so far it's just an empty spot on the floor.

The floor is strewn with innumerable strata of dirty laundry, which is soft and nice to stand on.

On the bed is nothing.

On the nightstand is nothing.

A terminal sits here, radiating importance and cyan light.

You can also see Purrl and a blanket here.

>x shop
It's the latest location for Star Anise Shop, the best shop for buying things from Star Anise!

* * *

>x shop
It's the latest location for Star Anise Shop, the best shop for buying things from Star Anise!

So far, though, it's nothing more than a clear space on the floor.
It still needs:
- something big with an opening, to act as a stall
- a name painted on the stall
- stars to decorate it
- at least three kinds of high quality merchandise
- a customer

>cut shop
Cutting it up would achieve little.

>push laundry into shop
You can't see any such thing.

>actions
Actions listing on.

>push purrl into shop
You can't see any such thing.

>put purrl into shop
[inserting Purrl into the shop]
(first taking Purrl)
[(1) taking Purrl - silently]
I don't suppose Purrl would care for that.
[(1) taking Purrl - silently - failed the can't take other people rule]

[inserting Purrl into the shop - failed the can't insert what's not held rule]

* * *

>climb purrl
You climb awkwardly on top of Purrl.

>open closet
You grasp the doorknob in both paws and wrestle with it a bit.  It unlatches, and the door swings open!  You did it!!

>go in closet
Neon's closet (on Purrl)
The closet is spacious, which is exciting, but mostly contains clothes, which is not.

What really catches your eye is the cardboard box tucked in the corner.  It's been taped shut, and one side reads FRAGILE.

You can also see a closet door here.

Purrl arrives from the closet door.

>open box
You can't see any such thing.

>push box
You can't see any such thing.

>x box
You can't see any such thing.

>scope
1: a closet door (686670)
2: a doorknob (686702)
3: Purrl (686606)
4: yourself (686030)
5: a shop (687598)
6: a blanket (686190)
7: some laundry (686062)
8: a bedroom door (686094)
9: a glowing panel (686542)
10: a bed (686126)
11: a pillow (686158)
12: a nightstand (686222)
13: a lamp (686254)
14: a desk (686286)
15: a terminal (686318)
16: a workbench (686350)
17: a mug (686382)
18: some construction paper (686414)
19: some scissors (686446)
20: some shelves (686478)
21: a strange machine (686510)
22: some lights (686926)
23: a keypad (686958)
24: a red button (686990)
25: a large square recess (687022)

>x panel
This glowing rectangle is clearly the secret to your escape.  Also, it glows, and that makes you want to touch it very badly.

>rules
Rules tracing now switched on. Type "rules off" to switch it off again, or "rules all" to include even rules which do not apply.

>scope
[Rule "Smarter Parser advanced replace blank line rule" applies.]
[Rule "Numbered Disambiguation Choices strip closing parenthesis rule" applies.]
[Rule "declare everything initially unmentioned rule" applies.]
1: a closet door (686670)
2: a doorknob (686702)
3: Purrl (686606)
4: yourself (686030)
5: a shop (687598)
6: a blanket (686190)
7: some laundry (686062)
8: a bedroom door (686094)
9: a glowing panel (686542)
10: a bed (686126)
[Rule "Rule for deciding the concealed possessions of a platform" applies.]
11: a pillow (686158)
12: a nightstand (686222)
[Rule "Rule for deciding the concealed possessions of a platform" applies.]
13: a lamp (686254)
14: a desk (686286)
[Rule "Rule for deciding the concealed possessions of a platform" applies.]
15: a terminal (686318)
16: a workbench (686350)
[Rule "Rule for deciding the concealed possessions of a platform" applies.]
17: a mug (686382)
[Rule "Rule for deciding the concealed possessions of a platform" applies.]
18: some construction paper (686414)
[Rule "Rule for deciding the concealed possessions of a platform" applies.]
19: some scissors (686446)
20: some shelves (686478)
21: a strange machine (686510)
22: some lights (686926)
23: a keypad (686958)
24: a red button (686990)
25: a large square recess (687022)

>showme cardboard box
[Rule "Smarter Parser advanced replace blank line rule" applies.]
[Rule "Numbered Disambiguation Choices strip closing parenthesis rule" applies.]
[Rule "declare everything initially unmentioned rule" applies.]
cardboard box - closed container
    tape (part of cardboard box)
    electronic junk
location: in Neon's closet
singular-named, improper-named; unlit, inedible, portable, seen, familiar; opaque, closed, unopenable, unlocked; unsealed
list grouping key: none
printed name: "cardboard box"
printed plural name: "containers"
indefinite article: none
description: "You extra love cardboard boxes.  Sometimes they're good to climb in."
initial appearance: "What really catches your eye is the cardboard box tucked in the corner.  It's been taped shut, and one side reads FRAGILE."
disambiguation id: 0
carrying capacity: 100

>touch panel
[Rule "Smarter Parser advanced replace blank line rule" applies.]
[Rule "Numbered Disambiguation Choices strip closing parenthesis rule" applies.]
[Rule "Rule for deciding the concealed possessions of a platform" applies.]
[Rule "Rule for deciding the concealed possessions of a platform" applies.]
[Rule "Rule for deciding the concealed possessions of a platform" applies.]
[Rule "Rule for deciding the concealed possessions of a platform" applies.]
[Rule "Rule for deciding the concealed possessions of a platform" applies.]
[Rule "Rule for deciding the concealed possessions of a platform" applies.]
[Rule "declare everything initially unmentioned rule" applies.]
[Rule "announce items from multiple object lists rule" applies.]
[Rule "set pronouns from items from multiple object lists rule" applies.]
[Rule "before stage rule" applies.]
[Rule "Accessibility rule" applies.]
[Rule "A tangibility rule for the glowing panel" applies.]
[Rule "Tangibility rule for something ( called the target ) not enclosed by a platform" applies.]
[Rule "instead stage rule" applies.]
[Rule "investigate player's awareness before action rule" applies.]
[Rule "player aware of his own actions rule" applies.]
[Rule "check stage rule" applies.]
[Rule "carry out stage rule" applies.]
[Rule "after stage rule" applies.]
[Rule "After touching the panel" applies.]
You pap your paws against the panel.  It makes some delightful noises and flashes red for a moment.

[Rule "A first turn sequence rule" applies.]
[Rule "every turn stage rule" applies.]
[Rule "A last turn sequence rule" applies.]
[Rule "notify score changes rule" applies.]

* * *

>rules off
[Rule "Smarter Parser advanced replace blank line rule" applies.]
[Rule "Numbered Disambiguation Choices strip closing parenthesis rule" applies.]
[Rule "declare everything initially unmentioned rule" applies.]
Rules tracing now switched off. Type "rules" to switch it on again.

>touch bed
You feel nothing unexpected.

>down
You can't go that way.

The only way to go is west.

>get off
You hop down off of Purrl.
Neon's bedroom
The lights are off and there are no windows, but the room is lit well enough by the cyan glow from the terminal on Neon's desk and the blinking LEDs on the strange machine in the corner.

The desk and an adjacent workbench run along the entire length of one wall.  shelves take up the opposite wall, except for a strange machine in the corner.  In the center of the room is a bed, unmade; on either side are a nightstand and a closet door.  The bedroom door is, of course, closed behind you.

Your new shop is taking shape, though so far it's just an empty spot on the floor.

The floor is strewn with innumerable strata of dirty laundry, which is soft and nice to stand on.

On the bed is nothing.

On the nightstand is nothing.

On the desk is nothing.

On the workbench is nothing.

You can also see Purrl and a blanket here.

>go in closet
Neon's closet
The closet is spacious, which is exciting, but mostly contains clothes, which is not.

What really catches your eye is the cardboard box tucked in the corner.  It's been taped shut, and one side reads FRAGILE.

You can also see a closet door here.

Purrl arrives from the closet door.

>look
Neon's closet
The closet is spacious, which is exciting, but mostly contains clothes, which is not.

What really catches your eye is the cardboard box tucked in the corner.  It's been taped shut, and one side reads FRAGILE.

You can also see Purrl and a closet door here.

>x box
You extra love cardboard boxes.  Sometimes they're good to climb in.

>get on purrl
You climb awkwardly on top of Purrl.

>look
Neon's closet (on Purrl)
The closet is spacious, which is exciting, but mostly contains clothes, which is not.

What really catches your eye is the cardboard box tucked in the corner.  It's been taped shut, and one side reads FRAGILE.

You can also see a closet door here.

>x box
You extra love cardboard boxes.  Sometimes they're good to climb in.

>leave
You hop down off of Purrl.
Neon's closet
The closet is spacious, which is exciting, but mostly contains clothes, which is not.

What really catches your eye is the cardboard box tucked in the corner.  It's been taped shut, and one side reads FRAGILE.

You can also see Purrl and a closet door here.

>leave
Neon's bedroom
The lights are off and there are no windows, but the room is lit well enough by the cyan glow from the terminal on Neon's desk and the blinking LEDs on the strange machine in the corner.

The desk and an adjacent workbench run along the entire length of one wall.  shelves take up the opposite wall, except for a strange machine in the corner.  In the center of the room is a bed, unmade; on either side are a nightstand and a closet door.  The bedroom door is, of course, closed behind you.

Your new shop is taking shape, though so far it's just an empty spot on the floor.

The floor is strewn with innumerable strata of dirty laundry, which is soft and nice to stand on.

On the bed is nothing.

On the nightstand is nothing.

On the desk is nothing.

On the workbench is nothing.

You can also see a blanket here.

>z
Time passes.

>look
Neon's bedroom
The lights are off and there are no windows, but the room is lit well enough by the cyan glow from the terminal on Neon's desk and the blinking LEDs on the strange machine in the corner.

The desk and an adjacent workbench run along the entire length of one wall.  shelves take up the opposite wall, except for a strange machine in the corner.  In the center of the room is a bed, unmade; on either side are a nightstand and a closet door.  The bedroom door is, of course, closed behind you.

Your new shop is taking shape, though so far it's just an empty spot on the floor.

The floor is strewn with innumerable strata of dirty laundry, which is soft and nice to stand on.

On the bed is nothing.

On the nightstand is nothing.

On the desk is nothing.

On the workbench is nothing.

You can also see a blanket here.

>go to closet
Neon's closet
The closet is spacious, which is exciting, but mostly contains clothes, which is not.

What really catches your eye is the cardboard box tucked in the corner.  It's been taped shut, and one side reads FRAGILE.

You can also see a closet door and Purrl here.

Purrl goes through the closet door.

>look
Neon's closet
The closet is spacious, which is exciting, but mostly contains clothes, which is not.

What really catches your eye is the cardboard box tucked in the corner.  It's been taped shut, and one side reads FRAGILE.

You can also see a closet door here.

>open box
It isn't something you can open.

* * *

>get on purrl
Purrl reluctantly leans down for you, and you clamber awkwardly on top of her helmet.

[on Purrl]

>open closet
You grasp the doorknob in both paws and wrestle with it a bit.  It unlatches, and the door swings open!  You did it!!

Purrl folds her arms.

>look
Neon's bedroom (on Purrl)
The lights are off and there are no windows, but the room is lit well enough by the cyan glow from the terminal on Neon's desk and the blinking LEDs on the strange machine in the corner.

The desk and an adjacent workbench run along the entire length of one wall.  shelves take up the opposite wall, except for a strange machine in the corner.  In the center of the room is a bed, unmade; on either side are a nightstand and a closet door.  The bedroom door is, of course, closed behind you.

Your new shop is taking shape, though so far it's just an empty spot on the floor.

The floor is strewn with innumerable strata of dirty laundry, which is soft and nice to stand on.

On the bed is a pillow.

On the nightstand is a lamp.

On the desk is a terminal.

On the workbench are a mug, some construction paper, and some scissors.

You can also see a blanket here.

>w
Neon's closet (on Purrl)
The closet is spacious, which is exciting, but mostly contains clothes, which is not.  Back through the closet door is the bedroom.

What really catches your eye is the cardboard box tucked in the corner.  It's been taped shut, and one side reads FRAGILE.

>x box
You extra love cardboard boxes.  Sometimes they're good to climb in.

>e
Neon's bedroom (on Purrl)
The lights are off and there are no windows, but the room is lit well enough by the cyan glow from the terminal on Neon's desk and the blinking LEDs on the strange machine in the corner.

The desk and an adjacent workbench run along the entire length of one wall.  shelves take up the opposite wall, except for a strange machine in the corner.  In the center of the room is a bed, unmade; on either side are a nightstand and a closet door.  The bedroom door is, of course, closed behind you.

Your new shop is taking shape, though so far it's just an empty spot on the floor.

The floor is strewn with innumerable strata of dirty laundry, which is soft and nice to stand on.

On the bed is a pillow.

On the nightstand is a lamp.

On the desk is a terminal.

On the workbench are a mug, some construction paper, and some scissors.

You can also see a blanket here.

>go to closet
Neon's closet (on Purrl)
The closet is spacious, which is exciting, but mostly contains clothes, which is not.  Back through the closet door is the bedroom.

What really catches your eye is the cardboard box tucked in the corner.  It's been taped shut, and one side reads FRAGILE.

Purrl arrives from the closet door.

>x box
You can't see any such thing.

>undo
Neon's bedroom
[Previous turn undone.]

>undo
Neon's bedroom
[Previous turn undone.]

>actions
Actions listing on.

>go to closet
[entering the closet door]
[(1) going the closet door]

Neon's closet (on Purrl)
The closet is spacious, which is exciting, but mostly contains clothes, which is not.  Back through the closet door is the bedroom.

What really catches your eye is the cardboard box tucked in the corner.  It's been taped shut, and one side reads FRAGILE.

[(1) going the closet door - succeeded]

[(1) Purrl entering the closet door]
[(2) Purrl going the closet door]
Purrl arrives from the closet door.
[(2) Purrl going the closet door - succeeded]

[(1) Purrl entering the closet door - succeeded]

[entering the closet door - succeeded]

>showme purrl
Purrl - rideable animal
    yourself - person
location: in Neon's bedroom
singular-named, proper-named; unlit, inedible, fixed in place, seen, familiar; female; willing to be used as a footstool
list grouping key: none
printed name: "Purrl"
printed plural name: "rideable animals"
indefinite article: none
description: "It's your best friend, Purrl!  The two of you sure have had a lot of exciting adventures together!  You fondly reminisce about some of them, like the time you were trapped in the Chamber of Despair.

She catches you staring at her and scowls.  M.O.R.S.E.L., the fish swimming around inside her helmet, also seems to scowl."
initial appearance: none
disambiguation id: 0
carrying capacity: 100

>showme me
yourself - person
location: carried by on Purrl in Neon's bedroom
singular-named, proper-named; unlit, inedible, portable, seen, familiar; male
list grouping key: none
printed name: "yourself"
printed plural name: "people"
indefinite article: none
description: "You are Star Anise, coolest of the lunekos."
initial appearance: none
disambiguation id: 0
carrying capacity: 1

>purrl, go to closet
[asking Purrl to try entering the closet door]
Purrl snorts, but does as you ask.
[(1) Purrl entering the closet door]
[(2) Purrl going the closet door]
Purrl arrives from the closet door.
[(2) Purrl going the closet door - succeeded]

[(1) Purrl entering the closet door - succeeded]

[asking Purrl to try entering the closet door - succeeded]

>look
[looking]
Neon's closet (on Purrl)
The closet is spacious, which is exciting, but mostly contains clothes, which is not.  Back through the closet door is the bedroom.

What really catches your eye is the cardboard box tucked in the corner.  It's been taped shut, and one side reads FRAGILE.

[looking - succeeded]

>actions off
Actions listing off.

>x box
You extra love cardboard boxes.  Sometimes they're good to climb in.

>open box
You open the cardboard box, revealing some electronic junk.

* * *

>open closet
You grasp the doorknob in both paws and wrestle with it a bit.  It unlatches, and the door swings open!  You did it!!

Purrl folds her arms.

>w
Neon's closet (on Purrl)
The closet is spacious, which is exciting, but mostly contains clothes, which is not.  Back through the closet door is the bedroom.

What really catches your eye is the cardboard box tucked in the corner.  It's been taped shut, and one side reads FRAGILE.

* * *

>x box
You extra love cardboard boxes.  Sometimes they're good to climb in.

>open box
The box is taped shut.  You can't open it.

>x tape
The tape holds the box securely shut.

>pull tape
You struggle with the tape for a while, but this seems to be the good stuff.  You can't even find a corner where it's started to come loose.

>cut tape
You don't have anything to cut with.

>purloin scissors
[Purloined.]

>cut box
You succeed in punching a couple shallow dents into the thick cardboard, but not much else.

>cut tape
You painstakingly cut at the tape, which is much more difficult than it seems with these scissors, but manage to free the box flaps!

>cut tape
You painstakingly cut at the tape, which is much more difficult than it seems with these scissors, but manage to free the box flaps!

>x box
You extra love cardboard boxes.  Sometimes they're good to climb in.

* * *

>open box
You open the cardboard box, revealing some electronic junk.

>x junk
You don't know what any of this junk is, only that it's heavy and in your way.

>take junk
You pick up a dark green rectangle.  It doesn't react, and it's covered in sharp bits.  You toss it aside in disgust.

>look
Neon's closet (on Purrl)
The closet is spacious, which is exciting, but mostly contains clothes, which is not.  Back through the closet door is the bedroom.

What really catches your eye is the cardboard box tucked in the corner.  It's been taped shut, and one side reads FRAGILE.

>remove junk from box
You grab bits and pieces at random and toss them over your shoulder, emptying the box one circuit board at a time.  The delicate components clatter as they hit the wall and floor behind you.

>x box
You extra love cardboard boxes.  Sometimes they're good to climb in.

>take box
You're carrying too many things already.

>drop scissors
Dropped.

>take box
You pick up the cardboard box.

Taken.

>drop box
Dropped.

>push box
Nothing obvious happens.

>push box to bedroom
You can't see any such thing.

>push box east
The cardboard box cannot be pushed from place to place.

* * *

>w
Neon's closet (on Purrl)
The closet is spacious, which is exciting, but mostly contains clothes, which is not.  Back through the closet door is the bedroom.

What really catches your eye is the cardboard box tucked in the corner.  It's been taped shut, and one side reads FRAGILE.

>purloin scissors
[Purloined.]

>cut tape
You painstakingly cut at the tape, which is much more difficult than it seems with these scissors, but manage to free the box flaps!

>open box
You open the cardboard box, revealing some electronic junk.

>take box
The box is far too big and unwieldy for you to pick up.

>take junk
You pick up a dark green rectangle.  It doesn't react, and it's covered in sharp bits.  You toss it aside in disgust.

>remove junk from box
You grab bits and pieces at random and toss them over your shoulder, emptying the box one circuit board at a time.  The delicate components clatter as they hit the wall and floor behind you.

>push box
Nothing obvious happens.

>pull box
Nothing obvious happens.

>push box east
Neon's bedroom (on Purrl)
The lights are off and there are no windows, but the room is lit well enough by the cyan glow from the terminal on Neon's desk and the blinking LEDs on the strange machine in the corner.

The desk and an adjacent workbench run along the entire length of one wall.  shelves take up the opposite wall, except for a strange machine in the corner.  In the center of the room is a bed, unmade; on either side are a nightstand and a closet door.  The bedroom door is, of course, closed behind you.

Your new shop is taking shape, though so far it's just an empty spot on the floor.

The floor is strewn with innumerable strata of dirty laundry, which is soft and nice to stand on.

On the bed is a pillow.

On the nightstand is a lamp.

On the desk is a terminal.

On the workbench are a mug and some construction paper.

You can also see a blanket here.

>look
Neon's bedroom (on Purrl)
The lights are off and there are no windows, but the room is lit well enough by the cyan glow from the terminal on Neon's desk and the blinking LEDs on the strange machine in the corner.

The desk and an adjacent workbench run along the entire length of one wall.  shelves take up the opposite wall, except for a strange machine in the corner.  In the center of the room is a bed, unmade; on either side are a nightstand and a closet door.  The bedroom door is, of course, closed behind you.

What really catches your eye is the cardboard box tucked in the corner.  It's been taped shut, and one side reads FRAGILE.

Your new shop is taking shape, though so far it's just an empty spot on the floor.

The floor is strewn with innumerable strata of dirty laundry, which is soft and nice to stand on.

On the bed is a pillow.

On the nightstand is a lamp.

On the desk is a terminal.

On the workbench are a mug and some construction paper.

You can also see a blanket here.

>take blanket
You're carrying too many things already.

>i
You are carrying:
  some scissors

>put scissors on bed
You put the scissors on the bed.

>put box on bed
(first taking the cardboard box)
The box is far too big and unwieldy for you to pick up.

* * *

>open closet
You grasp the doorknob in both paws and wrestle with it a bit.  It unlatches, and the door swings open!  You did it!!

Purrl folds her arms.

>go in closet
Purrl frowns and shakes her head.  "I'm just giving you boots, Star Anise!!  I'm not carrying you around like a horse!  Don't horse me!!"

>down
You hop down off of Purrl.
Neon's bedroom
The lights are off and there are no windows, but the room is lit well enough by the cyan glow coming from Neon's desk and the blinking LEDs on the tall machine in the corner.

The desk and an adjacent workbench run along the entire length of one wall.  Some shelves take up the opposite wall, stopping short of the corner to make room for a tall machine.  In the center of the room is a bed; it's framed by a nightstand and a closet door in the western wall.  The bedroom door to the east is, of course, closed.

From down here, you can't see what's on the various raised surfaces around the room: the bed, nightstand, desk, workbench, and shelves.

Your new shop is taking shape!  So far, that shape is a clearing on the floor.

A little white pamphlet lies on the floor near the door.

The floor is strewn with innumerable strata of dirty laundry, all of which is soft and comfortable under your paws.  Purrl has found a nice shirt to wrap around herself.  Also on the floor are a blanket, a glue stick, and a bag of glitter.

>go in closet
Neon's closet
The closet is spacious, which is exciting, but mostly contains clothes, which is not.  Back through the closet door is the bedroom.

What really catches your eye is the cardboard box tucked in the corner.  It's been taped shut, and one side reads FRAGILE.

>out
Neon's bedroom
The lights are off and there are no windows, but the room is lit well enough by the cyan glow coming from Neon's desk and the blinking LEDs on the tall machine in the corner.

The desk and an adjacent workbench run along the entire length of one wall.  Some shelves take up the opposite wall, stopping short of the corner to make room for a tall machine.  In the center of the room is a bed; it's framed by a nightstand and a closet door in the western wall.  The bedroom door to the east is, of course, closed.

From down here, you can't see what's on the various raised surfaces around the room: the bed, nightstand, desk, workbench, and shelves.

Your new shop is taking shape!  So far, that shape is a clearing on the floor.

A little white pamphlet lies on the floor near the door.

The floor is strewn with innumerable strata of dirty laundry, all of which is soft and comfortable under your paws.  Purrl has found a nice shirt to wrap around herself.  Also on the floor are a blanket, a glue stick, and a bag of glitter.

Purrl gently pokes yourself.

>get on workbench
You get onto the workbench.

>undo
Neon's bedroom
[Previous turn undone.]

>rules
Rules tracing now switched on. Type "rules off" to switch it off again, or "rules all" to include even rules which do not apply.

* * *

>rules off
[Rule "Smarter Parser advanced replace blank line rule" applies.]
[Rule "Numbered Disambiguation Choices strip closing parenthesis rule" applies.]
[Rule "After reading a command" applies.]
[Rule "declare everything initially unmentioned rule" applies.]
Rules tracing now switched off. Type "rules" to switch it on again.

>look
Neon's bedroom (on the workbench)
The lights are off and there are no windows, but the room is lit well enough by the cyan glow coming from Neon's desk and the blinking LEDs on the tall machine in the corner.

The desk and an adjacent workbench run along the entire length of one wall.  Some shelves take up the opposite wall, stopping short of the corner to make room for a tall machine.  In the center of the room is a bed; it's framed by a nightstand and a closet door in the western wall.  The bedroom door to the east is, of course, closed.

From your vantage point atop the workbench, you could see what's on the various other raised surfaces around the room (the bed, nightstand, desk, and shelves), if you cared to take a look.

Your new shop is taking shape!  So far, that shape is a clearing on the floor.

A little white pamphlet lies on the floor near the door.

The floor is strewn with innumerable strata of dirty laundry, all of which is soft and comfortable under your paws.  Purrl has found a nice shirt to wrap around herself.  Also on the floor are a blanket, a glue stick, and a bag of glitter.

>take scissors
You pick up the scissors.

Purrl gently pokes the blanket.

>down
You hop down off of the workbench.

Neon's bedroom
The lights are off and there are no windows, but the room is lit well enough by the cyan glow coming from Neon's desk and the blinking LEDs on the tall machine in the corner.

The desk and an adjacent workbench run along the entire length of one wall.  Some shelves take up the opposite wall, stopping short of the corner to make room for a tall machine.  In the center of the room is a bed; it's framed by a nightstand and a closet door in the western wall.  The bedroom door to the east is, of course, closed.

From down here, you can't see what's on the various raised surfaces around the room: the bed, nightstand, desk, workbench, and shelves.

Your new shop is taking shape!  So far, that shape is a clearing on the floor.

A little white pamphlet lies on the floor near the door.

The floor is strewn with innumerable strata of dirty laundry, all of which is soft and comfortable under your paws.  Purrl has found a nice shirt to wrap around herself.  Also on the floor are a blanket, a glue stick, and a bag of glitter.

>kick pamphlet
Nothing obvious happens.

>cut up pamphlet
You do your best to cut the pamphlet into a Star Anise shape, but something goes wrong and all you're left with is confetti.

Purrl yawns.

>shred pamphlet
You can't see any such thing.

>go in closet
Neon's closet
The closet is spacious, which is exciting, but mostly contains clothes, which is not.  Back through the closet door is the bedroom.

What really catches your eye is the cardboard box tucked in the corner.  It's been taped shut, and one side reads FRAGILE.

>cut tape
You painstakingly cut at the tape, which is much more difficult than it seems with these scissors, but manage to free the box flaps!

* * *

>open box
You open the cardboard box, revealing some electronic junk.

>take junk
You grab bits and pieces at random and toss them over your shoulder, emptying the box one circuit board at a time.  The delicate components clatter as they hit the wall and floor behind you.

>push box out
Neon's bedroom
The lights are off and there are no windows, but the room is lit well enough by the cyan glow coming from Neon's desk and the blinking LEDs on the tall machine in the corner.

The desk and an adjacent workbench run along the entire length of one wall.  Some shelves take up the opposite wall, stopping short of the corner to make room for a tall machine.  In the center of the room is a bed; it's framed by a nightstand and a closet door in the western wall.  The bedroom door to the east is, of course, closed.

From down here, you can't see what's on the various raised surfaces around the room: the bed, nightstand, desk, workbench, and shelves.

Your new shop is taking shape!  So far, that shape is a clearing on the floor.

The floor is strewn with innumerable strata of dirty laundry, all of which is soft and comfortable under your paws.  Purrl has found a nice shirt to wrap around herself.  Also on the floor are some confetti, a blanket, a glue stick, and a bag of glitter.

Purrl gently pokes yourself.

>look
Neon's bedroom
The lights are off and there are no windows, but the room is lit well enough by the cyan glow coming from Neon's desk and the blinking LEDs on the tall machine in the corner.

The desk and an adjacent workbench run along the entire length of one wall.  Some shelves take up the opposite wall, stopping short of the corner to make room for a tall machine.  In the center of the room is a bed; it's framed by a nightstand and a closet door in the western wall.  The bedroom door to the east is, of course, closed.

From down here, you can't see what's on the various raised surfaces around the room: the bed, nightstand, desk, workbench, and shelves.

Your new shop is taking shape!  So far, that shape is a clearing on the floor.

The floor is strewn with innumerable strata of dirty laundry, all of which is soft and comfortable under your paws.  Purrl has found a nice shirt to wrap around herself.  Also on the floor are a cardboard box (empty), some confetti, a blanket, a glue stick, and a bag of glitter.

>push box west
Neon's closet
The closet is spacious, which is exciting, but mostly contains clothes, which is not.  Back through the closet door is the bedroom.

A bunch of electronic junk is strewn across the floor.

>rules
Rules tracing now switched on. Type "rules off" to switch it off again, or "rules all" to include even rules which do not apply.

* * *

>get on purrl
Purrl reluctantly leans down for you, and you clamber awkwardly on top of her helmet.

[on Purrl]

>open closet door
You grasp the doorknob in both paws and wrestle with it a bit.  It unlatches, and the door swings open!  You did it!!

>down
You can't go that way.

The only way to go is west.

>get off
You hop down off of Purrl.
Neon's bedroom
The lights are off and there are no windows, but the room is lit well enough by the cyan glow coming from Neon's desk and the blinking LEDs on the strange machine in the corner.

The desk and an adjacent workbench run along the entire length of one wall.  Some shelves take up the opposite wall, stopping short of the corner to make room for a strange machine.  In the center of the room is a bed; it's framed by a nightstand and a closet door in the western wall.  The bedroom door to the east is, of course, closed.

From down here, you can't see what's on the various raised surfaces around the room: the bed, nightstand, desk, workbench, and shelves.

Your new shop is taking shape!  So far, though, it's nothing more than a clear space on the floor.

The floor is strewn with innumerable strata of dirty laundry, all of which is soft and comfortable under your paws.  Purrl has found a nice shirt to wrap around herself.  Also on the floor is a blanket.

>w
Neon's closet
The closet is spacious, which is exciting, but mostly contains clothes, which is not.  Back through the closet door is the bedroom.

What really catches your eye is the cardboard box tucked in the corner.  It's been taped shut, and one side reads FRAGILE.

>e
Neon's bedroom
The lights are off and there are no windows, but the room is lit well enough by the cyan glow coming from Neon's desk and the blinking LEDs on the strange machine in the corner.

The desk and an adjacent workbench run along the entire length of one wall.  Some shelves take up the opposite wall, stopping short of the corner to make room for a strange machine.  In the center of the room is a bed; it's framed by a nightstand and a closet door in the western wall.  The bedroom door to the east is, of course, closed.

From down here, you can't see what's on the various raised surfaces around the room: the bed, nightstand, desk, workbench, and shelves.

Your new shop is taking shape!  So far, though, it's nothing more than a clear space on the floor.

The floor is strewn with innumerable strata of dirty laundry, all of which is soft and comfortable under your paws.  Purrl has found a nice shirt to wrap around herself.  Also on the floor is a blanket.

>look under workbench
You find nothing of interest.

>climb workbench
Purrl gets onto the workbench.

>take scissors
You pick up the scissors.

>down
You get off the workbench.

Neon's bedroom
The lights are off and there are no windows, but the room is lit well enough by the cyan glow coming from Neon's desk and the blinking LEDs on the strange machine in the corner.

The desk and an adjacent workbench run along the entire length of one wall.  Some shelves take up the opposite wall, stopping short of the corner to make room for a strange machine.  In the center of the room is a bed; it's framed by a nightstand and a closet door in the western wall.  The bedroom door to the east is, of course, closed.

From down here, you can't see what's on the various raised surfaces around the room: the bed, nightstand, desk, workbench, and shelves.

Your new shop is taking shape!  So far, though, it's nothing more than a clear space on the floor.

The floor is strewn with innumerable strata of dirty laundry, all of which is soft and comfortable under your paws.  Also on the floor is a blanket.

Purrl gets off the workbench.

>w
Neon's closet
The closet is spacious, which is exciting, but mostly contains clothes, which is not.  Back through the closet door is the bedroom.

What really catches your eye is the cardboard box tucked in the corner.  It's been taped shut, and one side reads FRAGILE.

>cut tape
You painstakingly cut at the tape, which is much more difficult than it seems with these scissors, but manage to free the box flaps!

* * *

>take junk
You grab bits and pieces at random and toss them over your shoulder, emptying the box one circuit board at a time.  The delicate components clatter as they hit the wall and floor behind you.

>push box to bedroom
You can't see any such thing.

>push box east
Neon's bedroom
The lights are off and there are no windows, but the room is lit well enough by the cyan glow coming from Neon's desk and the blinking LEDs on the strange machine in the corner.

The desk and an adjacent workbench run along the entire length of one wall.  Some shelves take up the opposite wall, stopping short of the corner to make room for a strange machine.  In the center of the room is a bed; it's framed by a nightstand and a closet door in the western wall.  The bedroom door to the east is, of course, closed.

From down here, you can't see what's on the various raised surfaces around the room: the bed, nightstand, desk, workbench, and shelves.

Your new shop is taking shape!  So far, though, it's nothing more than a clear space on the floor.

The floor is strewn with innumerable strata of dirty laundry, all of which is soft and comfortable under your paws.  Purrl has found a nice shirt to wrap around herself.  Also on the floor is a blanket.

>push box into shop
You can't see any such thing.

>put box in shop
Hmm.  It's close, but a box with an open top doesn't make for a good stall.

>add box to shop
Hmm.  It's close, but a box with an open top doesn't make for a good stall.

>put box on shop
Hmm.  It's close, but a box with an open top doesn't make for a good stall.

>flip box
That's not a verb I recognize.

>turn box over
If you can see an object, you can usually just interact with it directly without worrying about your position. Try a command like EXAMINE MUG for a closer look at something, LOOK to get a new description of this location, or a direction like WEST (or W) to move to a different location.

To stop these messages entirely, type NOVICE OFF.

>turn box
You flip the box over, converting it elegantly into a stall for your shop!

>x stall
This was once a cardboard box, but now it's an upside-down cardboard box.  It's in dire need of some decoration.

>put stall in shop
You position the box-turned-stall inside your little clearing.  Perfect!

>put stall in shop
You position the box-turned-stall inside your little clearing.  Perfect!

>take stall
That seems to be a part of the shop.

>x machine
This metal cylinder stretches from floor to ceiling and is covered in blinking lights.  It hums cheerfully.  You love everything about it.

It has a keypad, a red button, and a large square recess, though all of it's out of your reach.

* * *

>get on purrl
Purrl reluctantly leans down for you, and you clamber awkwardly on top of her helmet.

[on Purrl]

>type star
I didn't understand that sentence.

>type star on keypad
You carefully type in the one word you're absolutely sure how to spell: STAR.  The machine chirps.

Purrl grumbles.

>push button
The machine beeps aggressively, and a red light next to the slot flashes on.

"Mewo!!  That's enough, Star Anise!  Get off of me!!"  Purrl shakes her head back and forth, sending you tumbling to the floor.

>get on purrl
You climb awkwardly on top of Purrl's helmet.

>down
You hop down off of Purrl.
Neon's bedroom
The lights are off and there are no windows, but the room is lit well enough by the cyan glow coming from Neon's desk and the blinking LEDs on the tall machine in the corner.

The desk and an adjacent workbench run along the entire length of one wall.  Some shelves take up the opposite wall, stopping short of the corner to make room for a tall machine.  In the center of the room is a bed; it's framed by a nightstand and a closet door in the western wall.  The bedroom door to the east is, of course, closed.

From down here, you can't see what's on the various raised surfaces around the room: the bed, nightstand, desk, workbench, and shelves.

Your new shop is taking shape!  So far, that shape is a clearing on the floor.

A little white pamphlet lies on the floor near the door.

The floor is strewn with innumerable strata of dirty laundry, all of which is soft and comfortable under your paws.  Purrl has found a nice shirt to wrap around herself.  Also on the floor are a blanket, a glue stick, and a bag of glitter.

>x slot
Looks like little things come out of here.  You have a keen sense for places where little things come out of, and this is one of them.

In the large square slot is a Lily figurine.

>take figurine
You pick up the Lily figurine.

Purrl blows some bubbles in her helmet.

* * *

>get on purrl
Purrl reluctantly leans down for you, and you clamber awkwardly on top of her helmet.

[on Purrl]

>type star on keypad
You carefully type in the one word you're absolutely sure how to spell: STAR.  The machine chirps.

Purrl bats at her antenna.

>down
You hop down off of Purrl.
Neon's bedroom
The lights are off and there are no windows, but the room is lit well enough by the cyan glow coming from Neon's desk and the blinking LEDs on the tall machine in the corner.

The desk and an adjacent workbench run along the entire length of one wall.  Some shelves take up the opposite wall, stopping short of the corner to make room for a tall machine.  In the center of the room is a bed; it's framed by a nightstand and a closet door in the western wall.  The bedroom door to the east is, of course, closed.

From down here, you can't see what's on the various raised surfaces around the room: the bed, nightstand, desk, workbench, and shelves.

Your new shop is taking shape!  So far, that shape is a clearing on the floor.

A little white pamphlet lies on the floor near the door.

The floor is strewn with innumerable strata of dirty laundry, all of which is soft and comfortable under your paws.  Purrl has found a nice shirt to wrap around herself.  Also on the floor are a blanket, a glue stick, and a bag of glitter.

>x slot
Looks like little things come out of here.  You have a keen sense for places where little things come out of, and this is one of them.

In the large square slot is a Lily figurine.

Purrl gently pokes the pamphlet.

>take figurine
You stand on your tippy toes, but you just can't reach the Lily figurine.  You AOOWWR in frustration.

>inventory
Your paws are empty.

>touch figurine
You stand on your tippy toes, but you just can't reach the Lily figurine.  You AOOWWR in frustration.

>get on purrl
You climb awkwardly on top of Purrl's helmet.

>hit figurine
You bat at the Lily figurine until it drops to the floor.

Purrl clears her throat loudly.

>push button
The machine whirrs for a moment.  A green light flashes on, and a gray star drops into the slot.

Purrl sighs dramatically.

>take star
You pick up the gray star.

Purrl bats at her antenna.

>take glitter
In your excitement, you forget all about the gray star you were holding and drop it.

You pick up the bag of glitter.

"Mewo!!  That's enough, Star Anise!  Get off of me!!"  Purrl shakes her head back and forth, sending you tumbling to the floor.

>get on bed
You can't climb with your hands full.  "AOOWWRR!" you wail in despair.

>drop
(the bag of glitter)
Dropped.

>take get on bed
I only understood the first part of that-- trying anyway.

Retrying as:
>TAKE GET

Type UNDO if this isn't what you wanted to do, or CORRECT OFF to stop automatically correcting commands.

To stop these messages entirely, type NOVICE OFF.

You can't see any such thing.

>get on bed
You get onto the bed.

The blanket has been stripped from the bed, but the pillow is still here.

>take star
The gray star is too far away!  You'll have to get closer.

Purrl wanders around.

>get on workbench
The workbench is too far away!  You'll have to get closer.

>down
You hop down off of the bed.

Neon's bedroom
The lights are off and there are no windows, but the room is lit well enough by the cyan glow coming from Neon's desk and the blinking LEDs on the tall machine in the corner.

The desk and an adjacent workbench run along the entire length of one wall.  Some shelves take up the opposite wall, stopping short of the corner to make room for a tall machine.  In the center of the room is a bed; it's framed by a nightstand and a closet door in the western wall.  The bedroom door to the east is, of course, closed.

From down here, you can't see what's on the various raised surfaces around the room: the bed, nightstand, desk, workbench, and shelves.

Your new shop is taking shape!  So far, that shape is a clearing on the floor.

A little white pamphlet lies on the floor near the door.

The floor is strewn with innumerable strata of dirty laundry, all of which is soft and comfortable under your paws.  Purrl has found a nice shirt to wrap around herself.  Also on the floor are a bag of glitter, a gray star, a Lily figurine, a blanket, and a glue stick.

>up
You can't go that way.

The only way to go is west.

>get on workbench
You get onto the workbench.

* * *

>get on purrl
Purrl reluctantly leans down for you, and you clamber awkwardly on top of her helmet.

[on Purrl]

>get on workbench
You hop from Purrl's helmet onto the workbench.

[on the workbench]

>push mug
You bat at the mug a few times, and it finally drops to the floor.

The laundry cushioned its fall, but the mug didn't survive unscathed.  It's now chipped.

>down
You hop down off of the workbench.

Neon's bedroom
The lights are off and there are no windows, but the room is lit well enough by the cyan glow coming from Neon's desk and the blinking LEDs on the tall machine in the corner.

The desk and an adjacent workbench run along the entire length of one wall.  Some shelves take up the opposite wall, stopping short of the corner to make room for a tall machine.  In the center of the room is a bed; it's framed by a nightstand and a closet door in the western wall.  The bedroom door to the east is, of course, closed.

Your new shop is taking shape!  So far, that shape is a clearing on the floor.

A little white pamphlet lies on the floor near the door.

The floor is strewn with innumerable strata of dirty laundry, all of which is soft and comfortable under your paws.  Purrl has found a nice shirt to wrap around herself.  Also on the floor are a chipped mug, a blanket, a glue stick, and a bag of glitter.

(From down here, you can't see what's on the various raised surfaces around the room.)

Purrl sticks her tongue out at you when you're not looking.

>take mug
You pick up the chipped mug.

>get on purrl
You climb awkwardly on top of Purrl's helmet.

>put mug on workbench
You put the chipped mug on the workbench.

Purrl snorts.

>get on workbench
You hop from Purrl's helmet onto the workbench.

>push mug
You bat at the mug a few times, and it finally drops to the floor.

The laundry cushioned its fall, but the mug didn't survive unscathed.  It's now cracked.

>down
You hop down off of the workbench.

Neon's bedroom
The lights are off and there are no windows, but the room is lit well enough by the cyan glow coming from Neon's desk and the blinking LEDs on the tall machine in the corner.

The desk and an adjacent workbench run along the entire length of one wall.  Some shelves take up the opposite wall, stopping short of the corner to make room for a tall machine.  In the center of the room is a bed; it's framed by a nightstand and a closet door in the western wall.  The bedroom door to the east is, of course, closed.

Your new shop is taking shape!  So far, that shape is a clearing on the floor.

A little white pamphlet lies on the floor near the door.

The floor is strewn with innumerable strata of dirty laundry, all of which is soft and comfortable under your paws.  Purrl has found a nice shirt to wrap around herself.  Also on the floor are a cracked mug, a blanket, a glue stick, and a bag of glitter.

(From down here, you can't see what's on the various raised surfaces around the room.)

Purrl gently pokes the bag of glitter.

>take mug
You pick up the cracked mug.

>climb purrl
You climb awkwardly on top of Purrl's helmet.

>put mug on workbench
You put the cracked mug on the workbench.

Purrl clears her throat loudly.

>push mug
The mug is too far away!  You'll have to get closer.

Purrl and M.O.R.S.E.L. exchange annoyed looks.

>get on workbench
You hop from Purrl's helmet onto the workbench.

>push mug
You bat at the mug a few times, and it finally drops to the floor.

It put on a brave face, but the mug finally shatters.

>look
Neon's bedroom (on the workbench)
The lights are off and there are no windows, but the room is lit well enough by the cyan glow coming from Neon's desk and the blinking LEDs on the tall machine in the corner.

The desk and an adjacent workbench run along the entire length of one wall.  Some shelves take up the opposite wall, stopping short of the corner to make room for a tall machine.  In the center of the room is a bed; it's framed by a nightstand and a closet door in the western wall.  The bedroom door to the east is, of course, closed.

Your new shop is taking shape!  So far, that shape is a clearing on the floor.

A little white pamphlet lies on the floor near the door.

The floor is strewn with innumerable strata of dirty laundry, all of which is soft and comfortable under your paws.  Purrl has found a nice shirt to wrap around herself.  Also on the floor are some broken pieces of a mug, a blanket, a glue stick, and a bag of glitter.

(From your vantage point atop the workbench, you can get a better look at the various other raised surfaces around the room.)

A broad flat plain stretches out in front of you.

On the workbench you can see a construction paper and some scissors.

>cut paper
You don't have anything to cut with.

Purrl wanders around.

* * *

>get on workbench
You hop from Purrl's helmet onto the workbench.

[on the workbench]

>look
Neon's bedroom (on the workbench)
The lights are off and there are no windows, but the room is lit well enough by the cyan glow coming from Neon's desk and the blinking LEDs on the tall machine in the corner.

The desk, with a drawer underneath, and an adjacent workbench run along the entire length of one wall.  Some shelves take up the opposite wall, stopping short of the corner to make room for a tall machine.  In the center of the room is a bed; it's framed by a nightstand and a closet door in the western wall.  The bedroom door to the east is, of course, closed.

Your new shop is taking shape!  So far, that shape is a clearing on the floor.

A little white pamphlet lies on the floor near the door.

The floor is strewn with innumerable strata of dirty laundry, all of which is soft and comfortable under your paws.  Purrl has found a nice shirt to wrap around herself.  Also on the floor is a blanket.

(From your vantage point atop the workbench, you can get a better look at the various other raised surfaces around the room.)

The workbench is a warm painted wood, in stark contrast to the cold metal desk right next to it.  This is where the magic happens, if "magic" is the appearance of a lot of things that roll around.

On the workbench you can see a mug and some construction paper.

[on the workbench]

>look shirt
You see nothing special about the laundry.

[on the workbench]

* * *

>get on purrl
Purrl reluctantly leans down for you, and you clamber awkwardly on top of her helmet.

[on Purrl]

>hit lily
You bat at the Lily figurine until it drops to the floor.

Purrl snorts.

[on Purrl]

>push button
The machine whirrs for a moment.  A green light flashes on, and a gray cube drops into the slot.

Purrl bats at her antenna.

[on Purrl]

>take cube
You pick up the gray cube.

Purrl folds her arms.

[on Purrl, holding a gray cube]

>drop cube
Dropped.

"Mewo!!  That's enough, Star Anise!  Get off of me!!"  Purrl shakes her head back and forth, sending you tumbling to the floor.

[on the floor]

>look
Neon's bedroom
The lights are off and there are no windows, but the room is lit well enough by the cyan glow coming from Neon's desk and the blinking LEDs on the tall machine in the corner.

The desk and an adjacent workbench run along the entire length of one wall.  Some shelves take up the opposite wall, stopping short of the corner to make room for a tall machine.  In the center of the room is a bed; it's framed by a nightstand and a closet door in the western wall.  The bedroom door to the east is, of course, closed.

Your new shop is taking shape!  So far, that shape is a clearing on the floor.

A little white pamphlet lies on the floor near the door.

The floor is strewn with innumerable strata of dirty laundry, all of which is soft and comfortable under your paws.  Purrl has found a nice shirt to wrap around herself.  Also on the floor are a gray cube, a Lily figurine, and a blanket.

(From down here, you can't see what's on the various raised surfaces around the room.)

[on the floor]

>get on purrl
Purrl reluctantly leans down for you, and you clamber awkwardly on top of her helmet.

[on Purrl]

>push button
The machine whirrs for a moment.  A green light flashes on, and a gray cube drops into the slot.

Purrl bats at her antenna.

[on Purrl]

>take cube
You pick up the gray cube.

Purrl clears her throat loudly.

[on Purrl, holding a gray cube]

>look
Neon's bedroom (on Purrl)
The lights are off and there are no windows, but the room is lit well enough by the cyan glow coming from Neon's desk and the blinking LEDs on the tall machine in the corner.

The desk and an adjacent workbench run along the entire length of one wall.  Some shelves take up the opposite wall, stopping short of the corner to make room for a tall machine.  In the center of the room is a bed; it's framed by a nightstand and a closet door in the western wall.  The bedroom door to the east is, of course, closed.

Your new shop is taking shape!  So far, that shape is a clearing on the floor.

A little white pamphlet lies on the floor near the door.

The floor is strewn with innumerable strata of dirty laundry, all of which is soft and comfortable under your paws.  Purrl has found a nice shirt to wrap around herself.  Also on the floor are a gray cube, a Lily figurine, and a blanket.

(From your vantage point atop Purrl, you can get a better look at the various raised surfaces around the room.)

Purrl grumbles.

[on Purrl, holding a gray cube]

>down
You hop down off of Purrl.
Neon's bedroom
The lights are off and there are no windows, but the room is lit well enough by the cyan glow coming from Neon's desk and the blinking LEDs on the tall machine in the corner.

The desk and an adjacent workbench run along the entire length of one wall.  Some shelves take up the opposite wall, stopping short of the corner to make room for a tall machine.  In the center of the room is a bed; it's framed by a nightstand and a closet door in the western wall.  The bedroom door to the east is, of course, closed.

Your new shop is taking shape!  So far, that shape is a clearing on the floor.

A little white pamphlet lies on the floor near the door.

The floor is strewn with innumerable strata of dirty laundry, all of which is soft and comfortable under your paws.  Purrl has found a nice shirt to wrap around herself.  Also on the floor are a gray cube, a Lily figurine, and a blanket.

(From down here, you can't see what's on the various raised surfaces around the room.)

[on the floor, holding a gray cube]

>drop
(the gray cube)
Dropped.

[on the floor]

>get on bed
You get onto the bed.

The blanket has been stripped from the bed, but the pillow is still here.

Purrl jumps up suddenly, then sits back down.

[on the bed]

>get on nightstand
You get onto the nightstand.

This little platform is the perfect size for you!

On the nightstand you can see some scissors and a lamp.

[on the nightstand]

>down
You hop down off of the nightstand.

Neon's bedroom
The lights are off and there are no windows, but the room is lit well enough by the cyan glow coming from Neon's desk and the blinking LEDs on the tall machine in the corner.

The desk and an adjacent workbench run along the entire length of one wall.  Some shelves take up the opposite wall, stopping short of the corner to make room for a tall machine.  In the center of the room is a bed; it's framed by a nightstand and a closet door in the western wall.  The bedroom door to the east is, of course, closed.

Your new shop is taking shape!  So far, that shape is a clearing on the floor.

A little white pamphlet lies on the floor near the door.

The floor is strewn with innumerable strata of dirty laundry, all of which is soft and comfortable under your paws.  Purrl has found a nice shirt to wrap around herself.  Also on the floor are two gray cubes, a Lily figurine, and a blanket.

(From down here, you can't see what's on the various raised surfaces around the room.)

[on the floor]

>x nightstand
It's like a table, but very small.  Doesn't make a lot of sense, if you think about it.

You can't see what's on the nightstand from here.

[on the floor]

* * *

>look
Neon's bedroom
The lights are off and there are no windows, but the room is lit well enough by the cyan glow coming from Neon's desk and the blinking LEDs on the tall machine in the corner.

The desk and an adjacent workbench run along the entire length of one wall.  Some shelves take up the opposite wall, stopping short of the corner to make room for a tall machine.  In the center of the room is a bed; it's framed by a nightstand and a closet door in the western wall.  The bedroom door to the east is, of course, closed.

From down here, you can't see what's on the various raised surfaces around the room: the bed, nightstand, desk, workbench, and shelves.

Your new shop is taking shape!  So far, though, it's nothing more than a clear space on the floor.

A little white pamphlet lies on the floor near the door.

The floor is strewn with innumerable strata of dirty laundry, all of which is soft and comfortable under your paws.  Purrl has found a nice shirt to wrap around herself.  Also on the floor are a blanket, a glue stick, and a bag of glitter.

* * *

>take glitter
You pick up the bag of glitter.

>put glitter on purrl
Putting things on Purrl would achieve nothing.

>get on purrl
You climb awkwardly on top of Purrl.

>drop glitter
Dropped.

>look
Neon's bedroom (on Purrl)
The lights are off and there are no windows, but the room is lit well enough by the cyan glow coming from Neon's desk and the blinking LEDs on the tall machine in the corner.

The desk and an adjacent workbench run along the entire length of one wall.  Some shelves take up the opposite wall, stopping short of the corner to make room for a tall machine.  In the center of the room is a bed; it's framed by a nightstand and a closet door in the western wall.  The bedroom door to the east is, of course, closed.

From your vantage point atop Purrl, you could see what's on the various raised surfaces around the room (the bed, nightstand, desk, workbench, and shelves), if you cared to take a look.

Your new shop is taking shape!  So far, that shape is a clearing on the floor.

A little white pamphlet lies on the floor near the door.

The floor is strewn with innumerable strata of dirty laundry, all of which is soft and comfortable under your paws.  Purrl has found a nice shirt to wrap around herself.  Also on the floor are a blanket and a glue stick.

On Purrl you can see a bag of glitter.

>showme purrl
Purrl - rideable animal
    bag of glitter
    yourself - person
location: in Neon's bedroom
singular-named, proper-named; unlit, inedible, fixed in place, seen, familiar; female; willing to be used as a footstool
list grouping key: none
printed name: "Purrl"
printed plural name: "rideable animals"
indefinite article: none
description: "It's your best friend, Purrl!  The two of you sure have had a lot of exciting adventures together!  You fondly reminisce about some of them, like the time you were trapped in the Chamber of Despair.

She catches you staring at her and scowls.  M.O.R.S.E.L., the fish swimming around inside her helmet, also seems to scowl."
initial appearance: none
disambiguation id: 0
carrying capacity: 100

* * *

>showme purrl
Purrl - rideable animal
    bag of glitter
    glue stick
    pamphlet
    blanket
location: in Neon's bedroom
singular-named, proper-named; unlit, inedible, fixed in place, seen, familiar; female; willing to be used as a footstool
list grouping key: none
printed name: "Purrl"
printed plural name: "rideable animals"
indefinite article: none
description: "It's your best friend, Purrl!  The two of you sure have had a lot of exciting adventures together!  You fondly reminisce about some of them, like the time you were trapped in the Chamber of Despair.

She catches you staring at her and scowls.  M.O.R.S.E.L., the fish swimming around inside her helmet, also seems to scowl."
initial appearance: none
disambiguation id: 0
carrying capacity: 100

* * *

>x clearing
It's the latest location for Star Anise Shop, the best shop for buying things from Star Anise!

It needs something, though.  Like, literally anything.  Something big and flat to act as a stall would be a good start.

>get on purrl
You climb awkwardly on top of Purrl's helmet.

Purrl clears her throat loudly.

>open closet
You grasp the doorknob in both paws and wrestle with it a bit.  It unlatches, and the door swings open!  You did it!!

Purrl snorts.

>x closet
Unlike the main entrance, this closet door sports a much lower-tech doorknob and hinges.

"Mewo!!  That's enough, Star Anise!  Get off of me!!"  Purrl shakes her head back and forth, sending you tumbling to the floor.

Neon's bedroom
The lights are off and there are no windows, but the room is lit well enough by the cyan glow coming from Neon's desk and the blinking LEDs on the tall machine in the corner.

The desk and an adjacent workbench run along the entire length of one wall.  Some shelves take up the opposite wall, stopping short of the corner to make room for a tall machine.  In the center of the room is a bed; it's framed by a nightstand and a closet door in the western wall.  The bedroom door to the east is, of course, closed.

From down here, you can't see what's on the various raised surfaces around the room: the bed, nightstand, desk, workbench, and shelves.

Your new shop is taking shape!  So far, that shape is a clearing on the floor.

A little white pamphlet lies on the floor near the door.

The floor is strewn with innumerable strata of dirty laundry, all of which is soft and comfortable under your paws.  Purrl has found a nice shirt to wrap around herself.  Also on the floor are a blanket, a glue stick, and a bag of glitter.

>get on purrl
You climb awkwardly on top of Purrl's helmet.

Purrl folds her arms.

>look in closet
You find nothing of interest.

Purrl clears her throat loudly.

>actions
Actions listing on.

>look in closet
[searching the closet door]
You find nothing of interest.
[searching the closet door - failed the can't search unless container or supporter rule]

Purrl snorts.

>go in closet
[entering the closet door]
Purrl frowns and shakes her head.  "I'm just giving you boots, Star Anise!!  I'm not carrying you around like a horse!  Don't horse me!!"
[entering the closet door - failed]

"Mewo!!  That's enough, Star Anise!  Get off of me!!"  Purrl shakes her head back and forth, sending you tumbling to the floor.

[looking]
Neon's bedroom
The lights are off and there are no windows, but the room is lit well enough by the cyan glow coming from Neon's desk and the blinking LEDs on the tall machine in the corner.

The desk and an adjacent workbench run along the entire length of one wall.  Some shelves take up the opposite wall, stopping short of the corner to make room for a tall machine.  In the center of the room is a bed; it's framed by a nightstand and a closet door in the western wall.  The bedroom door to the east is, of course, closed.

From down here, you can't see what's on the various raised surfaces around the room: the bed, nightstand, desk, workbench, and shelves.

Your new shop is taking shape!  So far, that shape is a clearing on the floor.

A little white pamphlet lies on the floor near the door.

The floor is strewn with innumerable strata of dirty laundry, all of which is soft and comfortable under your paws.  Purrl has found a nice shirt to wrap around herself.  Also on the floor are a blanket, a glue stick, and a bag of glitter.

[looking - succeeded]

* * *

>get on workbench
You get onto the workbench.

A broad flat plain stretches out in front of you.

On the workbench you can see a mug, a construction paper, and some scissors.

>push all
You can't use multiple objects with that verb.

>push mug
Nothing obvious happens.

You bat at the mug a few times, and it finally drops to the floor.

Purrl blows some bubbles in her helmet.

>push paper
Nothing obvious happens.

You bat at the construction paper a few times, and it finally drops to the floor.

>push scissors
Nothing obvious happens.

You bat at the scissors a few times, and they finally drop to the floor.

>down
You hop down off of the workbench.

Neon's bedroom
The lights are off and there are no windows, but the room is lit well enough by the cyan glow coming from Neon's desk and the blinking LEDs on the tall machine in the corner.

The desk and an adjacent workbench run along the entire length of one wall.  Some shelves take up the opposite wall, stopping short of the corner to make room for a tall machine.  In the center of the room is a bed; it's framed by a nightstand and a closet door in the western wall.  The bedroom door to the east is, of course, closed.

Your new shop is taking shape!  So far, that shape is a clearing on the floor.

A little white pamphlet lies on the floor near the door.

The floor is strewn with innumerable strata of dirty laundry, all of which is soft and comfortable under your paws.  Purrl has found a nice shirt to wrap around herself.  Also on the floor are some scissors, a construction paper, a mug, a blanket, a glue stick, and a bag of glitter.

(From down here, you can't see what's on the various raised surfaces around the room.)

>get on purrl
You climb awkwardly on top of Purrl's helmet.

>take figurine
You pick up the Lily figurine.

Purrl bats at her antenna.

>drop figurine
Dropped.

Purrl folds her arms.

>look
Neon's bedroom (on Purrl)
The lights are off and there are no windows, but the room is lit well enough by the cyan glow coming from Neon's desk and the blinking LEDs on the tall machine in the corner.

The desk and an adjacent workbench run along the entire length of one wall.  Some shelves take up the opposite wall, stopping short of the corner to make room for a tall machine.  In the center of the room is a bed; it's framed by a nightstand and a closet door in the western wall.  The bedroom door to the east is, of course, closed.

Your new shop is taking shape!  So far, that shape is a clearing on the floor.

A little white pamphlet lies on the floor near the door.

The floor is strewn with innumerable strata of dirty laundry, all of which is soft and comfortable under your paws.  Purrl has found a nice shirt to wrap around herself.  Also on the floor are some scissors, a construction paper, a mug, a blanket, a glue stick, and a bag of glitter.

(From your vantage point atop Purrl, you can get a better look at the various raised surfaces around the room.)

On Purrl you can see a Lily figurine.

Purrl bats at her antenna.

>type star
I didn't understand that sentence.

>type star on keypad
You carefully type in the one word you're absolutely sure how to spell: STAR.  The machine chirps.

"Mewo!!  That's enough, Star Anise!  Get off of me!!"  Purrl shakes her head back and forth, sending you tumbling to the floor.

>get on purrl
You climb awkwardly on top of Purrl's helmet.

On Purrl you can see a Lily figurine.

>push button
The machine whirrs for a moment.  A green light flashes on, and a gray star drops into the slot.

Purrl grumbles.

>push star
You bat at the gray star until it drops to the floor.

Purrl and M.O.R.S.E.L. exchange annoyed looks.

>down
You hop down off of Purrl.
Neon's bedroom
The lights are off and there are no windows, but the room is lit well enough by the cyan glow coming from Neon's desk and the blinking LEDs on the tall machine in the corner.

The desk and an adjacent workbench run along the entire length of one wall.  Some shelves take up the opposite wall, stopping short of the corner to make room for a tall machine.  In the center of the room is a bed; it's framed by a nightstand and a closet door in the western wall.  The bedroom door to the east is, of course, closed.

Your new shop is taking shape!  So far, that shape is a clearing on the floor.

A little white pamphlet lies on the floor near the door.

The floor is strewn with innumerable strata of dirty laundry, all of which is soft and comfortable under your paws.  Purrl has found a nice shirt to wrap around herself.  Also on the floor are a gray star, some scissors, a construction paper, a mug, a blanket, a glue stick, and a bag of glitter.

(From down here, you can't see what's on the various raised surfaces around the room.)

>search laundry
You toss some clothes in the air and generally have a great time.

Oh!  You spot something shiny under a jacket and dig it out.  It's a yellow star!

>x star
Which do you mean, the 1) yellow star or the 2) gray star?

>yellow
This star has too many points, but it's still a pretty good star.  It's metal and shiny and says "SHERIFF" in embossed letters.  All very good qualities.

>enter star on keypad
I only understood the first part of that-- trying anyway.

Retrying as:
>ENTER STAR

Type UNDO if this isn't what you wanted to do, or CORRECT OFF to stop automatically correcting commands.

To stop these messages entirely, type NOVICE OFF.

Which do you mean, the 1) yellow star or the 2) gray star?

>push laundry
You bat at the laundry a few times, but they don't move.

Purrl gently pokes the construction paper.

* * *

>test stall
>--> The following tests are available:
'test shop'
'test box'

>test box
(Testing.)

>[1] get on purrl
You clamber awkwardly on top of Purrl's helmet.

>[2] open closet
You grasp the doorknob in both paws and wrestle with it a bit.  It unlatches, and the door swings open!  You did it!!

Purrl folds her arms.

>[3] get on workbench
You hop from Purrl's helmet onto the workbench.

>[4] take scissors
You pick up the scissors.

>[5] down
You hop down off of the workbench.

Neon's bedroom
The lights are off and there are no windows, but the room is lit well enough by the cyan glow coming from Neon's desk and the blinking LEDs on the tall machine in the corner.

The desk and an adjacent workbench run along the entire length of one wall.  Some shelves take up the opposite wall, stopping short of the corner to make room for a tall machine.  In the center of the room is a bed; it's framed by a nightstand and a closet door in the western wall.  The bedroom door to the east is, of course, closed.

Your new shop is taking shape!  So far, that shape is a clearing on the floor.

A little white pamphlet lies on the floor near the door.

The floor is strewn with innumerable strata of dirty laundry, all of which is soft and comfortable under your paws.  Purrl has found a nice shirt to wrap around herself.  Also on the floor are a blanket, a glue stick, and a bag of glitter.

(From down here, you can't see what's on the various raised surfaces around the room.)

>[6] go in closet

Neon's closet
The closet is spacious, which is exciting, but mostly contains clothes, which is not.  Back through the closet door is the bedroom.

What really catches your eye is the cardboard box tucked in the corner.  It's been taped shut, and one side reads FRAGILE.

>[7] cut tape
You painstakingly cut at the tape, which is much more difficult than it seems with these scissors, but manage to free the box flaps!

>[8] open box
You open the cardboard box, revealing some electronic junk.

>[9] take junk
You grab bits and pieces at random and toss them over your shoulder, emptying the box one circuit board at a time.  The delicate components clatter as they hit the wall and floor behind you.

>[10] push box out
You shove the box ahead of you and manage to finagle it through the door.

Purrl sticks her tongue out at you when you're not looking.

>[11] flip box
You flip the box over, converting it elegantly into a stall for your shop!  You nudge it into position and gaze upon it with pride.

>flip box
You can't see any such thing.

>look
Neon's bedroom
The lights are off and there are no windows, but the room is lit well enough by the cyan glow coming from Neon's desk and the blinking LEDs on the tall machine in the corner.

The desk and an adjacent workbench run along the entire length of one wall.  Some shelves take up the opposite wall, stopping short of the corner to make room for a tall machine.  In the center of the room is a bed; it's framed by a nightstand and a closet door in the western wall.  The bedroom door to the east is, of course, closed.

Your new shop is taking shape!  It has a stall!

A little white pamphlet lies on the floor near the door.

The floor is strewn with innumerable strata of dirty laundry, all of which is soft and comfortable under your paws.  Purrl has found a nice shirt to wrap around herself.  Also on the floor are a blanket, a glue stick, and a bag of glitter.

(From down here, you can't see what's on the various raised surfaces around the room.)

Purrl blows some bubbles in her helmet.

>use glue on stall
You'll have to be more specific about what you're trying to do.

>put glue on box
You can't see any such thing.

>take glue
In your excitement, you forget all about the scissors you were holding and drop it.

You pick up the glue stick.

>put glue on box
You can't see any such thing.

>x box
You can't see any such thing.

>put glue on shop
Hmm, but how could you possibly sell a glue stick?

Purrl sticks her tongue out at you when you're not looking.

* * *

>test box
(Testing.)

[on the floor] >[1] get on purrl
Purrl reluctantly leans down for you, and you clamber awkwardly on top of her helmet.

[on Purrl] >[2] open closet
You grasp the doorknob in both paws and wrestle with it a bit.  It unlatches, and the door swings open!  You did it!!

Purrl clears her throat loudly.

[Your score has just gone up by five points.]

[on Purrl] >[3] get on nightstand
You hop from Purrl's helmet onto the nightstand.

[on the nightstand] >[4] take scissors
You pick up the scissors.

Purrl thinks about the blanket.

[on the nightstand, holding some scissors] >[5] down
You hop down off of the nightstand.

[on the floor, holding some scissors] >[6] go in closet

Neon's closet
The closet is spacious, which is exciting, but mostly contains clothes, which is not.  Back through the closet door is the bedroom.

What really catches your eye is the cardboard box tucked in the corner.  It's been taped shut, and one side reads FRAGILE.

[in the closet, holding some scissors] >[7] cut tape
You painstakingly cut at the tape, which is much more difficult than it seems with these scissors, but manage to free the box flaps!

[in the closet, holding some scissors] >[8] open box
You open the cardboard box, revealing some electronic junk.

[Your score has just gone up by five points.]

[in the closet, holding some scissors] >[9] take junk

You grab bits and pieces at random and toss them over your shoulder, emptying the box one circuit board at a time.  The delicate components clatter as they hit the wall and floor behind you.

[in the closet, holding some scissors] >[10] push box out
You shove the box ahead of you and manage to finagle it through the door.

Purrl gently pokes the blanket.

[on the floor, holding some scissors] >[11] flip box

You flip the box over, converting it elegantly into a stall for your shop!  You nudge it into position and gaze upon it with pride.

[Your score has just gone up by five points.]

[on the floor, holding some scissors] >[12] drop scissors
Dropped.

Purrl dusts off her tail.

[on the floor]

>put glue on box
You painstakingly write out your name in glue, real big.  You also put big scribbles of glue in places where stars could go.

>put glue on box
It probably has enough glue on it already.

>put glitter on box
You throw glitter haphazardly at the sticky parts.  Most of it gets on the floor, but eventually your name is spelled out across the front in big sparkly letters!

Purrl gently pokes the glue stick.

>x shop
This was once a cardboard box, but now it's an upside-down cardboard box.  Your name is written across the front in sparkly glitter.

It still needs some work:
- stars to decorate it
- some treasure to sell
But you'll get there!

>look
Neon's bedroom
The lights are off and there are no windows, but the room is lit well enough by the cyan glow coming from Neon's desk and the blinking LEDs on the tall machine in the corner.

The desk and an adjacent workbench run along the entire length of one wall.  Some shelves take up the opposite wall, stopping short of the corner to make room for a tall machine.  In the center of the room is a bed; it's framed by a nightstand and a closet door in the western wall.  The bedroom door to the east is, of course, closed.

Your new shop is taking shape!  It has a stall, and a name!

A little white pamphlet lies on the floor near the door.

The floor is strewn with innumerable strata of dirty laundry, all of which is soft and comfortable under your paws.  Purrl has found a nice shirt to wrap around herself.  Also on the floor are a blanket, a glue stick, and a bag of glitter.

(From down here, you can't see what's on the various raised surfaces around the room.)

>kick laundry
You kick some underwear!  Yeah!!  This is great!

>kick laundry
You kick a jacket!  Yeah!!  This is great!

>kick laundry
You kick some underwear!  Yeah!!  This is great!

Purrl gently pokes the pamphlet.

>put star on shop
You can't see any such thing.

>x shop
This was once a cardboard box, but now it's an upside-down cardboard box.  Your name is written across the front in sparkly glitter.

It still needs some work:
- stars to decorate it
- some treasure to sell
But you'll get there!

>showme box
(the stall)
stall - supporter
location: in Neon's bedroom
singular-named, improper-named; unlit, inedible, fixed in place, seen, familiar; sticky, entitled
list grouping key: none
printed name: "stall"
printed plural name: "supporters"
indefinite article: none
description: "This was once a cardboard box, but now it's an upside-down cardboard box.  Your name is written across the front in sparkly glitter.

It still needs some work:
- stars to decorate it
- some treasure to sell
But you'll get there!
"
initial appearance: "Your new shop is taking shape!  It has a stall, and a name!"
disambiguation id: 0
carrying capacity: 100
stellar count: 0

>search laundry
You toss some clothes in the air and generally have a great time.

Oh!  You spot something shiny under a jacket and dig it out.  It's a yellow star!

>decorate shop with star
(first taking the yellow star)
In your excitement, you forget all about the scissors you were holding and drop them.

You affix the yellow star proudly to the front of your stall.

>x shop
This was once a cardboard box, but now it's an upside-down cardboard box.  Your name is written across the front in sparkly glitter.  One star has been affixed to the front.

It still needs some work:
- more stars to decorate it
- some treasure to sell
But you'll get there!

>get on shop
That's not something you can enter.

>get on workbench
You get onto the workbench.

A broad flat plain stretches out in front of you.

On the workbench you can see a mug and a construction paper.

Purrl yawns.

>drop
What do you want to drop?

>get on workbench
But you're already on the workbench.

>push mug
You bat at the mug a few times, and it finally drops to the floor.

The laundry cushioned its fall, but the mug didn't survive unscathed.  It's now chipped.

>purloin mug
[Purloined.]

>push mug
That's hard to do when you're holding it.

>purloin mug
[Purloined.]

* * *

>push mug
That's hard to do when you're holding it.

>down
You hop down off of the workbench.

Neon's bedroom
The lights are off and there are no windows, but the room is lit well enough by the cyan glow coming from Neon's desk and the blinking LEDs on the tall machine in the corner.

The desk and an adjacent workbench run along the entire length of one wall.  Some shelves take up the opposite wall, stopping short of the corner to make room for a tall machine.  In the center of the room is a bed; it's framed by a nightstand and a closet door in the western wall.  The bedroom door to the east is, of course, closed.

Your new shop is taking shape!  It has a stall, and a name, and stars!

A little white pamphlet lies on the floor near the door.

The floor is strewn with innumerable strata of dirty laundry, all of which is soft and comfortable under your paws.  Purrl has found a nice shirt to wrap around herself.  Also on the floor are some scissors, a blanket, a glue stick, and a bag of glitter.

(From down here, you can't see what's on the various raised surfaces around the room.)

Purrl gently pokes the glue stick.

>i
You are carrying:
  a chipped mug

>put pieces in shop
You can't see any such thing.

>put pieces on shop
You can't see any such thing.

>x shop
This was once a cardboard box, but now it's an upside-down cardboard box.  Your name is written across the front in sparkly glitter.  One star has been affixed to the front.

It still needs some work:
- more stars to decorate it
- some treasure to sell
But you'll get there!

>get on workbench
You can't very well climb furniture with your hands full.  "AOOWWRR!" you wail in despair.

Purrl gently pokes the scissors.

>drop mug
Dropped.

>get on workbench
You get onto the workbench.

A broad flat plain stretches out in front of you.

On the workbench you can see a construction paper.

>purloin mug
[Purloined.]

>drop mug
Dropped.

>push mug
You bat at the mug a few times, and it finally drops to the floor.

The laundry cushioned its fall, but the mug didn't survive unscathed.  It's now cracked.

>purloin mug
[Purloined.]

* * *

>drop mug
Dropped.

>push mug
You bat at the mug a few times, and it finally drops to the floor.

It put on a brave face, but the mug finally shatters.

Purrl gently pokes the mug.

>down
You hop down off of the workbench.

Neon's bedroom
The lights are off and there are no windows, but the room is lit well enough by the cyan glow coming from Neon's desk and the blinking LEDs on the tall machine in the corner.

The desk and an adjacent workbench run along the entire length of one wall.  Some shelves take up the opposite wall, stopping short of the corner to make room for a tall machine.  In the center of the room is a bed; it's framed by a nightstand and a closet door in the western wall.  The bedroom door to the east is, of course, closed.

Your new shop is taking shape!  It has a stall, and a name, and stars!

A little white pamphlet lies on the floor near the door.

The floor is strewn with innumerable strata of dirty laundry, all of which is soft and comfortable under your paws.  Purrl has found a nice shirt to wrap around herself.  Also on the floor are some broken pieces of a mug, some scissors, a blanket, a glue stick, and a bag of glitter.

(From down here, you can't see what's on the various raised surfaces around the room.)

>take mug
You pick up the broken pieces of a mug.

>put mug in shop
You proudly set the broken pieces of a mug atop your stall.

>look
Neon's bedroom
The lights are off and there are no windows, but the room is lit well enough by the cyan glow coming from Neon's desk and the blinking LEDs on the tall machine in the corner.

The desk and an adjacent workbench run along the entire length of one wall.  Some shelves take up the opposite wall, stopping short of the corner to make room for a tall machine.  In the center of the room is a bed; it's framed by a nightstand and a closet door in the western wall.  The bedroom door to the east is, of course, closed.

Your new shop is taking shape!  It has a stall, and a name, and stars, and even some treasure!

On the stall is some broken pieces of a mug.

A little white pamphlet lies on the floor near the door.

The floor is strewn with innumerable strata of dirty laundry, all of which is soft and comfortable under your paws.  Purrl has found a nice shirt to wrap around herself.  Also on the floor are some scissors, a blanket, a glue stick, and a bag of glitter.

(From down here, you can't see what's on the various raised surfaces around the room.)

Purrl gently pokes the bag of glitter.

>x shop
This was once a cardboard box, but now it's an upside-down cardboard box.  Your name is written across the front in sparkly glitter.  One star has been affixed to the front.  Neatly arranged on top is some broken pieces of a mug.

It still needs some work:
- more stars to decorate it
- a bit more treasure to sell
But you'll get there!

On the stall is some broken pieces of a mug.

>showme stall
stall - supporter
    yellow star (part of stall) - Star
    broken pieces of a mug - Merch
location: in Neon's bedroom
singular-named, improper-named; unlit, inedible, fixed in place, seen, familiar; sticky, entitled
list grouping key: none
printed name: "stall"
printed plural name: "supporters"
indefinite article: none
description: "This was once a cardboard box, but now it's an upside-down cardboard box.  Your name is written across the front in sparkly glitter.  One star has been affixed to the front.  Neatly arranged on top is some broken pieces of a mug.

It still needs some work:
- more stars to decorate it
- a bit more treasure to sell
But you'll get there!
"
initial appearance: "Your new shop is taking shape!  It has a stall, and a name, and stars, and even some treasure!"
disambiguation id: 0
carrying capacity: 100
stellar count: 1

>showme mug
broken pieces of a mug - Merch
location: on the stall in Neon's bedroom
singular-named, improper-named; unlit, inedible, portable, handled, seen, familiar
list grouping key: none
printed name: "mug"
printed plural name: "Merches"
indefinite article: "some"
description: "These pieces used to be a single mug.  Now they're a lot of small toys, which is much better.
"
initial appearance: none
disambiguation id: 0
damage level: broken

* * *

>put glue on box
You painstakingly write out your name in glue, real big.  You also put big scribbles of glue in places where stars could go.

>throw glitter at box
(first taking the bag of glitter)
In your excitement, you forget all about the scissors you were holding and drop them.

You throw glitter haphazardly at the sticky parts.  Most of it gets on the floor, but eventually your name is spelled out across the front in big sparkly letters!

>search laundry
You toss some clothes in the air and generally have a great time.

Oh!  You spot something shiny under a jacket and dig it out.  It's a yellow star!

>put star on stall
You affix the yellow star proudly to the front of your stall.

Purrl gently pokes yourself.

>x stall
This was once a cardboard box, but now it's an upside-down cardboard box.  Your name is written across the front in sparkly glitter.  Affixed to the front is a yellow star.

It still needs some work:
- more stars to decorate it
- some treasure to sell
But you'll get there!

>take scissors
In your excitement, you forget all about the bag of glitter you were holding and drop it.

You pick up the scissors.

>get on purrl
Purrl reluctantly leans down for you, and you clamber awkwardly on top of her helmet.

>get on workbench
You hop from Purrl's helmet onto the workbench.

>cut paper
You do your very best to cut a star shape out of the paper.  It comes out absolutely perfect, of course.

>take star
(the blue star)
In your excitement, you forget all about the scissors you were holding and drop them.

You pick up the blue star.

>down
You hop down off of the workbench.

Neon's bedroom
The lights are off and there are no windows, but the room is lit well enough by the cyan glow coming from Neon's desk and the blinking LEDs on the tall machine in the corner.

The desk and an adjacent workbench run along the entire length of one wall.  Some shelves take up the opposite wall, stopping short of the corner to make room for a tall machine.  In the center of the room is a bed; it's framed by a nightstand and a closet door in the western wall.  The bedroom door to the east is, of course, closed.

Your new shop is taking shape!  It has a stall, and a name, and stars!

A little white pamphlet lies on the floor near the door.

The floor is strewn with innumerable strata of dirty laundry, all of which is soft and comfortable under your paws.  Purrl has found a nice shirt to wrap around herself.  Also on the floor are a bag of glitter, a blanket, and a glue stick.

(From down here, you can't see what's on the various raised surfaces around the room.)

Purrl gently pokes yourself.

>put star on shop
(the blue star on the stall)
You affix the blue star proudly to the front of your stall.

>get on purrl
Purrl reluctantly leans down for you, and you clamber awkwardly on top of her helmet.

>bap lily
You bat at the Lily figurine until it drops to the floor.

Purrl folds her arms.

>type star on machine
You carefully type in the one word you're absolutely sure how to spell: STAR.  The machine chirps.

Purrl sighs dramatically.

>push button
The machine whirrs for a moment.  A green light flashes on, and a gray star drops into the slot.

Purrl grumbles.

>take star
(the gray star)
You pick up the gray star.

"Mewo!!  That's enough, Star Anise!  Get off of me!!"  Purrl shakes her head back and forth, sending you tumbling to the floor.

>put star on shop
(the gray star on the stall)
You affix the gray star proudly to the front of your stall.

>x shop
This was once a cardboard box, but now it's an upside-down cardboard box.  Your name is written across the front in sparkly glitter.  Affixed to the front are a blue star, a yellow star, and a gray star.

It still needs some work:
- some treasure to sell
But you'll get there!

Purrl blows some bubbles in her helmet.

>climb shelves
You make your way up the shelves.  They're too short for your helmet to fit in, so the best you can do is hold onto them like a ladder.

>i
Your paws are empty.

>x shelves
On the shelves are an award and a tiny jar of paint.

>hit award
You bat at the award a few times, and it finally drops to the floor.

>hit paint
You bat at the tiny jar of paint a few times, and it finally drops to the floor.

>down
You hop down off of the shelves.

Neon's bedroom
The lights are off and there are no windows, but the room is lit well enough by the cyan glow coming from Neon's desk and the blinking LEDs on the tall machine in the corner.

The desk and an adjacent workbench run along the entire length of one wall.  Some shelves take up the opposite wall, stopping short of the corner to make room for a tall machine.  In the center of the room is a bed; it's framed by a nightstand and a closet door in the western wall.  The bedroom door to the east is, of course, closed.

Your new shop is taking shape!  It has a stall, and a name, and stars!

A little white pamphlet lies on the floor near the door.

The floor is strewn with innumerable strata of dirty laundry, all of which is soft and comfortable under your paws.  Purrl has found a nice shirt to wrap around herself.  Also on the floor are a tiny jar of paint, an award, a Lily figurine, a bag of glitter, a blanket, and a glue stick.

(From down here, you can't see what's on the various raised surfaces around the room.)

Purrl yawns.

>use paint on award
You'll have to be more specific about what you're trying to do.

>put paint on award
(first taking the tiny jar of paint)
You pour the paint all over the acrylic star and smear it around with your paws.  Soon enough, you have a moderately sticky red star, which you look at proudly.  You also have red paint all over yourself and everything nearby.  Art is easy!

[Your score has just gone up by five points.]

>look
Neon's bedroom
The lights are off and there are no windows, but the room is lit well enough by the cyan glow coming from Neon's desk and the blinking LEDs on the tall machine in the corner.

The desk and an adjacent workbench run along the entire length of one wall.  Some shelves take up the opposite wall, stopping short of the corner to make room for a tall machine.  In the center of the room is a bed; it's framed by a nightstand and a closet door in the western wall.  The bedroom door to the east is, of course, closed.

Your new shop is taking shape!  It has a stall, and a name, and stars!

A little white pamphlet lies on the floor near the door.

The floor is strewn with innumerable strata of dirty laundry, all of which is soft and comfortable under your paws.  Purrl has found a nice shirt to wrap around herself.  Also on the floor are a red star, a Lily figurine, a bag of glitter, a blanket, and a glue stick.

(From down here, you can't see what's on the various raised surfaces around the room.)

>put star on shop
(the red star on the stall)
You affix the red star proudly to the front of your stall.

* * *

>showme laser
laser engraver - thing
location: out of play
singular-named, improper-named; unlit, inedible, portable, unseen, unfamiliar
list grouping key: none
printed name: "laser engraver"
printed plural name: none
indefinite article: none
description: "For a more delicate hand, this would be perfect for burning fine patterns into things.  For you, well."
initial appearance: none
disambiguation id: 0
illustration: Figure of cover

[on the floor, holding some scissors]

* * *

>x shop
This was once a cardboard box, but now it's an upside-down cardboard box.  Your name is written across it in sparkly glitter.  Affixed to the front are a blue star, a yellow star, a gray star, a red star, and a black star.

It still needs some work:
- some treasure to sell
- a customer
But you'll get there!

[on the floor, holding some scissors]

* * *

>take scissors
You pick up the scissors.

[on the floor, holding some scissors]

>cut twine
You snip off a length of string.

[on the floor, holding some scissors]

>put string in shop
You proudly set the length of string atop your stall.

Purrl ignores the laser engraver.

[on the floor, holding some scissors]

>test finale
(Testing.)

[on the floor, holding some scissors] >[1] give coin to purrl
You can't see any such thing.

[on the floor, holding some scissors] >[2] open shop
You sit on your stall for a while and wait for some customers.  But nobody came.

Quite suddenly, the door slides open, revealing the big cat standing in the hallway.

Neon's eyes dart around the room.  The glitter everywhere, the mess in the closet...  "WHAT did you DO to my ROOM??" she bellows.

"Wow!!" you say.  "I knew it would work!  Star Anise Shop to the rescue again!!"  And you dart out the open door, leaving Neon to clean up the disaster you left in your wake.

    *** You've escaped the Chamber of Despair! ***

In that game you scored 27 out of a possible 21, in 92 turns.

Would you like to RESTART, RESTORE a saved game, QUIT, or UNDO the last command?

>undo
Neon's bedroom
[Previous turn undone.]

[on the floor, holding some scissors]

>look under bed
You peer under the bed.  It's too dark to see anything.

[on the floor, holding some scissors]

>drop
(the scissors)
Dropped.

[on the floor]

>get on nightstand
You get onto the nightstand.

This little platform is the perfect size for you!

On the nightstand you can see a lamp.

Purrl purrs for no particular reason.

[on the nightstand]

>turn on lamp
You switch the lamp on.

[on the nightstand]

>push lamp
You bat at the lamp, but nothing happens.  Undeterred, you brace your helmet against it and give it a good hard shove.  It topples off the nightstand and onto the floor with a heavy thud.

Purrl sits next to the laser engraver.

[on the nightstand]

>down
You hop down off of the nightstand.

Neon's bedroom
The nightstand lamp casts eerie shadows on the walls, ameliorated somewhat by the blinking LEDs on the tall machine in the corner.

The desk and an adjacent workbench run along the entire length of one wall.  Some shelves take up the opposite wall, stopping short of the corner to make room for a tall machine.  In the center of the room is a bed; it's framed by a nightstand and a closet door in the western wall.  The bedroom door to the east is, of course, closed.

Your new shop is taking shape!  It has a stall, and a name, and stars, and even some treasure!

On the stall are a length of string, a puffball, and some mug.

A little white pamphlet lies on the floor near the door.

The floor is strewn with innumerable strata of dirty laundry, all of which is soft and comfortable under your paws.  Purrl has found a nice shirt to wrap around herself.  Also on the floor are a lamp, some scissors, some paper scraps, a Lily figurine, a laser engraver, a glue stick, a bunch of stuff, a spool of twine, a bag of glitter, and a blanket.

(From down here, you can't see what's on the various raised surfaces around the room.)

[on the floor]

>look under bed
You peer under the bed.  Thanks to the lamplight, you can see a coin!  Score!  You love those!

You just barely reach it and pull it out.

[on the floor, holding a coin]

>give coin to purrl
"Purrl!!  Look!  I found a money!"  You wave it around, hopping from one foot to the other.  "Now you can be a customer!"

Purrl examines it suspiciously.  "Mmmnn.  Okay, but I'll only buy things that are my favorite.  No garbage!!"  She plucks it out of your hands.

[on the floor]

>open shop
You jump on your stall and wave your arms around.  "Hey hey hey Purrl hey Purrl!!  Look at my shop I made!!  Come check it out!!!!!!!!!"

Purrl strolls over and peruses your many wares.  "Mmmnn, I think I would like one string, please, mewo."  She hands you the coin, and you hand her the string.  She nods politely.  "Thank you."  She walks a short distance away and tumbles to the floor, rolling around playing with her string.

(...press a key...)

Quite suddenly, the door slides open, revealing the big cat standing in the hallway.

Neon's eyes dart around the room.  The glitter everywhere, the mess in the closet...  "WHAT did you DO to my ROOM??" she bellows.

"Wow!!" you say.  "I knew it would work!  Star Anise Shop to the rescue again!!"  And you dart out the open door, leaving Neon to clean up the disaster you left in your wake.

    *** You've escaped the Chamber of Despair! ***

In that game you scored 27 out of a possible 21, in 100 turns.

Would you like to RESTART, RESTORE a saved game, QUIT, or UNDO the last command?

>restart
You struggle and cry for help, but your captor ignores your feeble pleas.  They toss you, like garbage, into the darkness.  The heavy gate closes and locks behind you, sealing your fate.  Their maniacal laughter echoes into the distance, leaving you alone with your thoughts.

You are trapped.  Trapped...  in the Chamber of Despair.

Star Anise Chronicles: Escape from the Chamber of Despair
An Interactive Fiction by Eevee
Release 1 / Serial number 191217 / Inform 7 build 6M62 (I6/v6.33 lib 6/12N) SD

Neon's bedroom
The lights are off and there are no windows, but the room is lit well enough by the cyan glow coming from Neon's desk and the blinking LEDs on the tall machine in the corner.

The desk and an adjacent workbench run along the entire length of one wall.  Some shelves take up the opposite wall, stopping short of the corner to make room for a tall machine.  In the center of the room is a bed, unmade, a blanket hanging half off one side; it's framed by a nightstand and a closet door in the western wall.  The bedroom door to the east is, of course, closed.

A little white pamphlet lies on the floor near the door.

The floor is strewn with innumerable strata of dirty laundry, all of which is soft and comfortable under your paws.

(From down here, you can't see what's on the various raised surfaces around the room.)

[on the floor]

>about
Try typing LOOK for a description of your surroundings. Any directions indicate exits which you can use by typing WEST (or W). Some of the objects mentioned in the description might be worth a closer look with a command like EXAMINE SCISSORS. You can also TAKE or DROP some things, type INVENTORY to see a list of what you're carrying already, OPEN or CLOSE containers or doors, and so on.

To stop these messages entirely, type NOVICE OFF.

[on the floor]

>x scissors
You can't see any such thing.

[on the floor]

* * *

>test finale
(Testing.)

[on the floor, holding some scissors] >[1] drop
(the scissors)
Dropped.

Purrl jumps up suddenly, then sits back down.

[on the floor] >[2] get on nightstand
You get onto the nightstand.

This little platform is the perfect size for you!

On the nightstand you can see a lamp.

[on the nightstand] >[3] turn on lamp
You switch the lamp on.

Purrl bats at her antenna.

[on the nightstand] >[4] push lamp
You bat at the lamp, but nothing happens.  Undeterred, you brace your helmet against it and give it a good hard shove.  It topples off the nightstand and onto the floor with a heavy thud.

[on the nightstand] >[5] down
You hop down off of the nightstand.

Purrl jumps up suddenly, then sits back down.

[on the floor] >[6] look under bed
You peer under the bed.  Thanks to the lamplight, you can see a coin!  Score!  You love those!

You just barely reach it and pull it out.

[Your score has just gone up by three points.]

[on the floor, holding a coin] >[7] give coin to purrl
"Purrl!!  Look!  I found a money!"  You wave it around, hopping from one foot to the other.  "Now you can be a customer!"

Purrl examines it suspiciously.  "Mmmnn.  Okay, but I'll only buy things that are my favorite.  No garbage!!"  She plucks it out of your hands.

Purrl sits next to the glue stick.

[on the floor] >[8] open shop
You jump on your stall and wave your arms around.  "Hey hey hey Purrl hey Purrl!!  Look at my shop I made!!  Come check it out!!!!!!!!!"

Purrl strolls over and peruses your many wares.  "Mmmnn, I think I would like one string, please, mewo."  She hands you the coin, and you hand her the string.  She nods politely.  "Thank you."  She walks a short distance away and tumbles to the floor, rolling around playing with her string.

(cont'd)

Quite suddenly, the door slides open, revealing the big cat standing in the hallway.

Neon's eyes dart around the room.  The glitter everywhere, the mess in the closet, the state of her terminal...  "WHAT did you DO to my ROOM??" she bellows.

"Wow!!" you say.  "I knew it would work!  Star Anise Shop to the rescue again!!"  And you dart out the open door, leaving Neon to clean up the disaster you left in your wake.

    *** You've escaped the Chamber of Despair! ***

In that game you scored 88 out of a possible 100, in 97 turns.

Would you like to RESTART, RESTORE a saved game, QUIT, or UNDO the last command?

>restart
You struggle and cry for help, but your captor ignores your feeble pleas.  They toss you, like garbage, into the darkness.  The heavy gate closes and locks behind you, sealing your fate.  Their maniacal laughter echoes into the distance, leaving you alone with your thoughts.

You are trapped.  Trapped...  in the Chamber of Despair.

Star Anise Chronicles: Escape from the Chamber of Despair
An Interactive Fiction by Evelyn Woods
Release 1 / Serial number 191218 / Inform 7 build 6M62 (I6/v6.33 lib 6/12N) SD

Neon's bedroom
The lights are off and there are no windows, but the room is lit well enough by the cyan glow coming from Neon's desk and the blinking LEDs on the tall machine in the corner.

The desk, with a drawer underneath, and an adjacent workbench run along the entire length of one wall.  Some shelves take up the opposite wall, stopping short of the corner to make room for a tall machine.  In the center of the room is a bed, unmade, a blanket hanging half off one side; it's framed by a nightstand and a closet door in the western wall.  The bedroom door to the east is, of course, closed.

A little white pamphlet lies on the floor near the door.

The floor is strewn with innumerable strata of dirty laundry, all of which is soft and comfortable under your paws.

(From down here, you can't see what's on the various raised surfaces around the room.)

[on the floor]

>climb shelves
You make your way up the shelves.  They're too short for your helmet to fit in, so the best you can do is hold onto them like a ladder.

[on the shelves]

>drop shelves
You let go of the shelves, and it drops to the floor.

[on the shelves]

* * *

>undo
Neon's bedroom
[Previous turn undone.]

[on the floor, holding some scissors]

>undo
Neon's bedroom
[Previous turn undone.]

[on the floor, holding some scissors] >[12] drop scissors
Dropped.

[on the floor]

>undo
Neon's bedroom
[Previous turn undone.]

[on the floor, holding some scissors]

>undo
Neon's closet
[Previous turn undone.]

[on the floor, holding some scissors] >[11] flip box
There's not much room to move it around in here.

[on the floor, holding some scissors] >[12] drop scissors
Dropped.

[on the floor]

>undo
Neon's closet
[Previous turn undone.]

[on the floor, holding some scissors]

>look
Neon's closet
The closet is spacious, which is exciting, but mostly contains clothes, which is not.  Back through the closet door is the bedroom.

A bunch of electronic junk is piled around the floor.

What really catches your eye is the cardboard box tucked in the corner.  It's been haphazardly broken into, and one side reads FRAGILE.

[on the floor, holding some scissors]

>push box to bedroom
You can't see any such thing.

[on the floor, holding some scissors]

>actions
Actions listing on.

[on the floor, holding some scissors]

>push box to bedroom
You can't see any such thing.

[on the floor, holding some scissors]

>parser
[parser-debugging]
Smart Parser debugging on.
[parser-debugging - succeeded]

[on the floor, holding some scissors]

>push box to bedroom
You can't see any such thing.

[on the floor, holding some scissors]

>push box to east
[pushing the cardboard box to east]
[(1) going east]
You shove the box ahead of you and manage to finagle it through the door.
[(1) going east - succeeded]

[pushing the cardboard box to east - succeeded]

Purrl dusts off her tail.

[on the floor, holding some scissors]

>put scissors on nightstand
[putting the scissors on the nightstand]
You can't reach the nightstand from here.
[putting the scissors on the nightstand - failed the Check putting something on a platform ( called the shelf )]

[on the floor, holding some scissors]

>ask purrl for help
***Smarter Parser: matched on signs of confusion rule.
command at this point is "ask purrl for help".
Try typing LOOK for a description of your surroundings. Any directions indicate exits which you can use by typing WEST (or W). Some of the objects mentioned in the description might be worth a closer look with a command like EXAMINE AWARD. You can also TAKE or DROP some things, type INVENTORY to see a list of what you're carrying already, OPEN or CLOSE containers or doors, and so on.

To stop these messages entirely, type NOVICE OFF.

[on the floor, holding some scissors]

>x mug
You can't see any such thing.

[on the floor, holding some scissors]

>showme mug
mug - Merch
location: on the workbench in Neon's bedroom
singular-named, improper-named; unlit, inedible, portable, seen, familiar
list grouping key: none
printed name: "mug"
printed plural name: "Merches"
indefinite article: none
description: "This completely pristine mug was left carelessly on the edge of a high surface.  Why, anything could happen to it!
"
initial appearance: none
disambiguation id: 0
illustration: Figure of cover
damage level: intact

[on the floor, holding some scissors]

>look
[looking]
Neon's bedroom
The lights are off and there are no windows, but the room is lit well enough by the cyan glow coming from Neon's desk and the blinking LEDs on the tall machine in the corner.

The desk and an adjacent workbench run along the entire length of one wall.  Some shelves take up the opposite wall, stopping short of the corner to make room for a tall machine.  In the center of the room is a bed; it's framed by a nightstand and a closet door in the western wall.  The bedroom door to the east is, of course, closed.

Your new shop is taking shape!  So far, that shape is a clearing on the floor.

A little white pamphlet lies on the floor near the door.

The floor is strewn with innumerable strata of dirty laundry, all of which is soft and comfortable under your paws.  Purrl has found a nice shirt to wrap around herself.  Also on the floor are a cardboard box (empty) and a blanket.

(From down here, you can't see what's on the various raised surfaces around the room.)

[looking - succeeded]

[on the floor, holding some scissors]

>flip box
[turning the cardboard box]
You flip the box over, converting it elegantly into a stall for your shop!  You nudge it into position and gaze upon it with pride.
[turning the cardboard box - failed]

[Your score has just gone up by five points.]

[on the floor, holding some scissors]

>purloin mug
[Purloined.]

[on the floor, holding some scissors]

>put mug on shop
[putting the mug on the stall]
You proudly set the mug atop your stall.
[putting the mug on the stall - failed]

[on the floor, holding some scissors]

>take mug
[taking the mug]
In your excitement, you forget all about the scissors you were holding and drop them.

You pick up the mug.
[taking the mug - succeeded]

[on the floor, holding a mug]

* * *

>LOOK
Neon's bedroom
The lights are off and there are no windows, but the room is lit well enough by the cyan glow coming from Neon's desk and the blinking LEDs on the tall machine in the corner.

The desk, with a drawer underneath, and an adjacent workbench run along the entire length of one wall.  Some shelves take up the opposite wall, stopping short of the corner to make room for a tall machine.  In the center of the room is a bed; it's framed by a nightstand and a closet door in the western wall.  The bedroom door to the east is, of course, closed.

Your new shop is taking shape!  It has a stall!

A little white pamphlet lies on the floor near the door.

The floor is strewn with innumerable strata of dirty laundry, all of which is soft and comfortable under your paws.  Purrl has found a nice shirt to wrap around herself.  Also on the floor are some scissors and a blanket.

(From down here, you can't see what's on the various raised surfaces around the room.)

[on the floor]

>LOOK
Neon's bedroom
The lights are off and there are no windows, but the room is lit well enough by the cyan glow coming from Neon's desk and the blinking LEDs on the tall machine in the corner.

The desk, with a drawer underneath, and an adjacent workbench run along the entire length of one wall.  Some shelves take up the opposite wall, stopping short of the corner to make room for a tall machine.  In the center of the room is a bed; it's framed by a nightstand and a closet door in the western wall.  The bedroom door to the east is, of course, closed.

Your new shop is taking shape!  It has a stall!

A little white pamphlet lies on the floor near the door.

The floor is strewn with innumerable strata of dirty laundry, all of which is soft and comfortable under your paws.  Purrl has found a nice shirt to wrap around herself.  Also on the floor are some scissors and a blanket.

(From down here, you can't see what's on the various raised surfaces around the room.)

[on the floor]

* * *

>take pamphlet
You pick up the pamphlet.

>get on purrl
Purrl reluctantly leans down for you, and you clamber awkwardly on top of her helmet.

>rules
Rules tracing now switched on. Type "rules off" to switch it off again, or "rules all" to include even rules which do not apply.

>drop pamphlet
[Rule "Smarter Parser advanced replace blank line rule" applies.]
[Rule "Numbered Disambiguation Choices strip closing parenthesis rule" applies.]
[Rule "After reading a command" applies.]
[Rule "Rule for deciding the concealed possessions of a platform" applies.]
[Rule "Rule for deciding the concealed possessions of a platform" applies.]
[Rule "Rule for deciding the concealed possessions of a platform" applies.]
[Rule "declare everything initially unmentioned rule" applies.]
[Rule "announce items from multiple object lists rule" applies.]
[Rule "set pronouns from items from multiple object lists rule" applies.]
[Rule "before stage rule" applies.]
[Rule "Accessibility rule" applies.]
[Rule "Tangibility rule for something ( called the target ) not enclosed by a platform" applies.]
[Rule "A tangibility rule for something ( called the trinket )" applies.]
[Rule "instead stage rule" applies.]
[Rule "investigate player's awareness before action rule" applies.]
[Rule "player aware of his own actions rule" applies.]
[Rule "check stage rule" applies.]
[Rule "can't drop yourself rule" applies.]
[Rule "can't drop what's already dropped rule" applies.]
[Rule "can't drop what's not held rule" applies.]
[Rule "can't drop clothes being worn rule" applies.]
[Rule "can't drop if this exceeds carrying capacity rule" applies.]
[Rule "carry out stage rule" applies.]
[Rule "standard dropping rule" applies.]
[Rule "Last carry out dropping when the player is carried by Purrl" applies.]
[Rule "after stage rule" applies.]
[Rule "investigate player's awareness after action rule" applies.]
[Rule "report stage rule" applies.]
[Rule "standard report dropping rule" applies.]
Dropped.
[Rule "last specific action-processing rule" applies.]

[Rule "A first turn sequence rule" applies.]
[Rule "every turn stage rule" applies.]
[Rule "Every turn when Purrl is seen" applies.]
Purrl sighs dramatically.

[Rule "A last turn sequence rule" applies.]
[Rule "notify score changes rule" applies.]

>showme pamphlet
[Rule "Smarter Parser advanced replace blank line rule" applies.]
[Rule "Numbered Disambiguation Choices strip closing parenthesis rule" applies.]
[Rule "After reading a command" applies.]
[Rule "declare everything initially unmentioned rule" applies.]
pamphlet - thing
location: in Neon's bedroom
singular-named, improper-named; unlit, inedible, portable, handled, seen, familiar
list grouping key: none
printed name: "pamphlet"
printed plural name: none
indefinite article: none
description: "Welcome to interactive fiction!  I see you've already got the basics down.

As you can see, the game understands basic English instructions like READ THE PAMPHLET, as well as some slightly fancier constructs like TAKE THE COOKIE FROM THE JAR, but that's as complex as it gets.

Tip: X is short for EXAMINE!

You flip through the rest of the pamphlet, which contains detailed instructions and a complete walkthrough, but there aren't any pictures!  Not one!  Worthless."
initial appearance: "A little white pamphlet lies on the floor near the door."
disambiguation id: 0
illustration: Figure of cover

* * *

>purloin coin
[Purloined.]

>tell purrl about coin
Purrl folds her arms and looks off in a different direction.

>show coin to purrl
Purrl is unimpressed.

>actions
Actions listing on.

>tell purrl about coin
[telling Purrl about "coin"]
[(1) answering Purrl that "coin"]
Purrl folds her arms and looks off in a different direction.
[(1) answering Purrl that "coin" - failed]

[telling Purrl about "coin" - failed]

Purrl yawns.

>showme coin
coin - thing
location: carried by yourself in Neon's bedroom
singular-named, improper-named; unlit, inedible, portable, handled, unseen, unfamiliar
list grouping key: none
printed name: "coin"
printed plural name: none
indefinite article: none
description: "You've never heard of the kingdom of "Charl E. Cheez", but this coin is clearly gold, so it must be very valuable."
initial appearance: none
disambiguation id: 0
illustration: Figure of cover

>x coin
[examining the coin]
You've never heard of the kingdom of "Charl E. Cheez", but this coin is clearly gold, so it must be very valuable.

[examining the coin - succeeded]

>showme coin
coin - thing
location: carried by yourself in Neon's bedroom
singular-named, improper-named; unlit, inedible, portable, handled, seen, familiar
list grouping key: none
printed name: "coin"
printed plural name: none
indefinite article: none
description: "You've never heard of the kingdom of "Charl E. Cheez", but this coin is clearly gold, so it must be very valuable."
initial appearance: none
disambiguation id: 0
illustration: Figure of cover

>tell purrl about coin
[informing Purrl about the coin]
[(1) giving the coin to Purrl]
"Purrl!!  Look!  I found a money!"  You wave it around, hopping from one foot to the other.  "Now you can be a customer!"

Purrl examines it suspiciously.  "Mmmnn.  Okay, but I'll only buy things that are my favorite.  No garbage!!"  She plucks it out of your hands.
[(1) giving the coin to Purrl - succeeded]

[informing Purrl about the coin - failed]

>ask purrl about favorite
[asking Purrl about "favorite"]
[(1) answering Purrl that "favorite"]
Purrl taps her chin thoughtfully.  "Mmmnn, I'd hafta say that my favorite thing ever is string, and my second favorite thing ever is more string."
[(1) answering Purrl that "favorite" - failed]

[asking Purrl about "favorite" - failed]

Purrl sticks her tongue out at you when you're not looking.

>x purrl
[examining Purrl]

It's your best friend, Purrl!  The two of you sure have had a lot of exciting adventures together!  You fondly reminisce about some of them, like the time you were trapped in the Chamber of Despair.

She catches you staring at her and scowls.  M.O.R.S.E.L., the fish swimming around inside her helmet who likes you just as much as Purrl does, also seems to scowl.

[examining Purrl - succeeded]

>showme purrl
Purrl - rideable animal
    coin
location: in Neon's bedroom
singular-named, proper-named; unlit, inedible, fixed in place, seen, familiar; female; willing to be used as a footstool
list grouping key: none
printed name: "Purrl"
printed plural name: "rideable animals"
indefinite article: none
description: "It's your best friend, Purrl!  The two of you sure have had a lot of exciting adventures together!  You fondly reminisce about some of them, like the time you were trapped in the Chamber of Despair.

She catches you staring at her and scowls.  M.O.R.S.E.L., the fish swimming around inside her helmet who likes you just as much as Purrl does, also seems to scowl."
initial appearance: none
disambiguation id: 0
illustration: Figure Purrl
carrying capacity: 100
cooldown: 4
carry patience: 4

>actions off
Actions listing off.

>get on purrl
Purrl reluctantly leans down for you, and you clamber awkwardly on top of her helmet.

On Purrl you can see a coin.

>undo
Neon's bedroom
[Previous turn undone.]

* * *

>purloin coin
[Purloined.]

>x coin
You've never heard of the kingdom of "Charl E. Cheez", but this coin is clearly gold, so it must be very valuable.

Purrl gently pokes yourself.

>give coin to purrl
"Purrl!!  Look!  I found a money!"  You wave it around, hopping from one foot to the other.  "Now you can be a customer!"

Purrl examines it suspiciously.  "Mmmnn.  Okay, but I'll only buy things that are my favorite.  No garbage!!"  She plucks it out of your hands.

>x purrl
It's your best friend, Purrl!  The two of you sure have had a lot of exciting adventures together!  You fondly reminisce about some of them, like the time you were trapped in the Chamber of Despair.

She catches you staring at her and scowls.  M.O.R.S.E.L., the fish swimming around inside her helmet who likes you just as much as Purrl does, also seems to scowl.

Purrl is holding a coin.

>get on purrl
Purrl reluctantly leans down for you, and you clamber awkwardly on top of her helmet.

>look
Neon's bedroom (on Purrl)
The lights are off and there are no windows, but the room is lit well enough by the cyan glow coming from Neon's desk and the blinking LEDs on the tall machine in the corner.

The desk and an adjacent workbench run along the entire length of one wall.  Some shelves take up the opposite wall, stopping short of the corner to make room for a tall machine.  In the center of the room is a bed; it's framed by a nightstand and a closet door in the western wall.  The bedroom door to the east is, of course, closed.

Your new shop is taking shape!  So far, that shape is a clearing on the floor.

A little white pamphlet lies on the floor near the door.

The floor is strewn with innumerable strata of dirty laundry, all of which is soft and comfortable under your paws.  Purrl has found a nice shirt to wrap around herself.  Also on the floor is a blanket.

(From your vantage point atop Purrl, you can get a better look at the various raised surfaces around the room.)

Purrl bats at her antenna.

>look under purrl
You find nothing of interest.

Purrl snorts.

* * *

>test box
(Testing.)

[on the floor] >[1] get on purrl
Purrl reluctantly leans down for you, and you clamber awkwardly on top of her helmet.

[on Purrl] >[2] open closet
You grasp the doorknob in both paws and wrestle with it a bit.  It unlatches, and the door swings open!  You did it!!

Purrl snorts.

[on Purrl] >[3] get on nightstand
You hop from Purrl's helmet onto the nightstand.

[on the nightstand] >[4] take scissors
You pick up the scissors.

[on the nightstand, holding some scissors] >[5] down
You hop down off of the nightstand.

Neon's bedroom
The lights are off and there are no windows, but the room is lit well enough by the cyan glow coming from Neon's desk and the blinking LEDs on the tall machine in the corner.

The desk and an adjacent workbench run along the entire length of one wall.  Some shelves take up the opposite wall, stopping short of the corner to make room for a tall machine.  In the center of the room is a bed; it's framed by a nightstand and a closet door in the western wall.  The bedroom door to the east is, of course, closed.

Your new shop is taking shape!  So far, that shape is a clearing on the floor.

A little white pamphlet lies on the floor near the door.

The floor is strewn with innumerable strata of dirty laundry, all of which is soft and comfortable under your paws.  Purrl has found a nice shirt to wrap around herself.  Also on the floor are a construction paper, a chipped mug, a glue stick, a tiny jar of paint, a bunch of stuff, a spool of twine, a bag of glitter, and a blanket.

(From down here, you can't see what's on the various raised surfaces around the room.)

[on the floor, holding some scissors] >[6] go in closet

Neon's closet
The closet is spacious, which is exciting, but mostly contains clothes, which is not.  Back through the closet door is the bedroom.

What really catches your eye is the cardboard box tucked in the corner.  It's been taped shut, and one side reads FRAGILE.

[on the floor, holding some scissors] >[7] cut tape
You painstakingly cut at the tape, which is much more difficult than it seems with these scissors, but manage to free the box flaps!

[on the floor, holding some scissors] >[8] open box
You open the cardboard box, revealing an electronic junk.

[on the floor, holding some scissors] >[9] take junk
You grab bits and pieces at random and toss them over your shoulder, emptying the box one circuit board at a time.  The delicate components clatter as they hit the wall and floor behind you.

[on the floor, holding some scissors] >[10] push box out
You shove the box ahead of you and manage to finagle it through the door.

Purrl sticks her tongue out at you when you're not looking.

[on the floor, holding some scissors] >[11] flip box
You flip the box over, converting it elegantly into a stall for your shop!  You nudge it into position and gaze upon it with pride.

[on the floor, holding some scissors] >[12] drop scissors
Dropped.

[on the floor]

>look
Neon's bedroom
The lights are off and there are no windows, but the room is lit well enough by the cyan glow coming from Neon's desk and the blinking LEDs on the tall machine in the corner.

The desk and an adjacent workbench run along the entire length of one wall.  Some shelves take up the opposite wall, stopping short of the corner to make room for a tall machine.  In the center of the room is a bed; it's framed by a nightstand and a closet door in the western wall.  The bedroom door to the east is, of course, closed.

Your new shop is taking shape!  It has a stall!

A little white pamphlet lies on the floor near the door.

The floor is strewn with innumerable strata of dirty laundry, all of which is soft and comfortable under your paws.  Purrl has found a nice shirt to wrap around herself.  Also on the floor are some scissors, a construction paper, a chipped mug, a glue stick, a tiny jar of paint, a bunch of stuff, a spool of twine, a bag of glitter, and a blanket.

(From down here, you can't see what's on the various raised surfaces around the room.)

[on the floor]

>get on desk. push award. down
You get onto the desk.

The metal desk is surprisingly sparse, occupied mainly by a glowing terminal.  You miss when it was covered in documents that you could freely scatter everywhere, but for some reason, the big cat started putting them away somewhere.

On the desk you can see an award.

Purrl gently pokes the scissors.

You bat at the award a few times, and it finally drops to the floor.

You hop down off of the desk.

Neon's bedroom
The lights are off and there are no windows, but the room is lit well enough by the cyan glow coming from Neon's desk and the blinking LEDs on the tall machine in the corner.

The desk and an adjacent workbench run along the entire length of one wall.  Some shelves take up the opposite wall, stopping short of the corner to make room for a tall machine.  In the center of the room is a bed; it's framed by a nightstand and a closet door in the western wall.  The bedroom door to the east is, of course, closed.

Your new shop is taking shape!  It has a stall!

A little white pamphlet lies on the floor near the door.

The floor is strewn with innumerable strata of dirty laundry, all of which is soft and comfortable under your paws.  Purrl has found a nice shirt to wrap around herself.  Also on the floor are an award, some scissors, a construction paper, a chipped mug, a glue stick, a tiny jar of paint, a bunch of stuff, a spool of twine, a bag of glitter, and a blanket.

(From down here, you can't see what's on the various raised surfaces around the room.)

Purrl gently pokes the chipped mug.

[on the floor]

>tap mug
That's not a verb I recognize.

[on the floor]

* * *

>x morsel
M.O.R.S.E.L. is Purrl's...  pet?  Fish?  You're not really sure, but it hangs out in Purrl's helmet.

[on the floor]

>take morsel
M.O.R.S.E.L. is inside Purrl's helmet, safely out of your reach.

[on the floor]

* * *

>climb workbench
You get onto the workbench.

On the workbench you can see a mug, some construction paper, and some scissors.

>cut paper
You don't have anything to cut with.

>take scissors
You pick up the scissors.

Taken.

>cut paper
You do your very best to cut a star shape out of the paper.  It comes out absolutely perfect, of course.

>look
Neon's bedroom (on the workbench)
The lights are off and there are no windows, but the room is lit well enough by the cyan glow from the terminal on Neon's desk and the blinking LEDs on the strange machine in the corner.

The desk and an adjacent workbench run along the entire length of one wall.  shelves take up the opposite wall, except for a strange machine in the corner.  In the center of the room is a bed, unmade; on either side are a nightstand and a closet door.  The bedroom door is, of course, closed behind you.

The floor is strewn with innumerable strata of dirty laundry, which is soft and nice to stand on.

The blanket strewn haphazardly across the bed bears a circuit pattern, as well as a conspicuous lump in the middle.

On the bed is a pillow.

On the nightstand is a lamp.

On the desk is a terminal.

On the workbench you can see some paper scraps, a blue star, and a mug.

>take blue star
You pick up the blue star.

Taken.

>drop scissors
Dropped.

>down
You get off the workbench.

Neon's bedroom
The lights are off and there are no windows, but the room is lit well enough by the cyan glow from the terminal on Neon's desk and the blinking LEDs on the strange machine in the corner.

The desk and an adjacent workbench run along the entire length of one wall.  shelves take up the opposite wall, except for a strange machine in the corner.  In the center of the room is a bed, unmade; on either side are a nightstand and a closet door.  The bedroom door is, of course, closed behind you.

The floor is strewn with innumerable strata of dirty laundry, which is soft and nice to stand on.

The blanket strewn haphazardly across the bed bears a circuit pattern, as well as a conspicuous lump in the middle.

On the bed is nothing.

On the nightstand is nothing.

On the desk is nothing.

On the workbench is nothing.

>actions
Actions listing on.

>down
[going down]
You can't go that way.

[(1) listing exits]
The only way to go is west.

[(1) listing exits - succeeded]

[going down - failed]

>i
[taking inventory]
You are carrying:
  a blue star

[taking inventory - succeeded]

>actions off
Actions listing off.

>i
You are carrying:
  a blue star

* * *

>x machine
This metal cylinder stretches from floor to ceiling and is covered in blinking lights.  It hums cheerfully.  You love everything about it.

It has a keypad, a red button, and a large square recess, though all of it's out of your reach.

>push button
The machine hums for a moment.  A green light flashes on, and a gray cube drops into the recess.

>look
Neon's bedroom
The lights are off and there are no windows, but the room is lit well enough by the cyan glow from the terminal on Neon's desk and the blinking LEDs on the strange machine in the corner.

The desk and an adjacent workbench run along the entire length of one wall.  shelves take up the opposite wall, except for a strange machine in the corner.  In the center of the room is a bed, unmade; on either side are a nightstand and a closet door.  The bedroom door is, of course, closed behind you.

The floor is strewn with innumerable strata of dirty laundry, which is soft and nice to stand on.

The blanket strewn haphazardly across the bed bears a circuit pattern, as well as a conspicuous lump in the middle.

On the bed is nothing.

On the nightstand is nothing.

On the desk is nothing.

On the workbench is nothing.

>x machine
This metal cylinder stretches from floor to ceiling and is covered in blinking lights.  It hums cheerfully.  You love everything about it.

It has a keypad, a red button, and a large square recess, though all of it's out of your reach.

>x recess
In the large square recess is a cube.

>take cube
You pick up the cube.

Taken.

>drop cube
Dropped.

>push button
The machine hums for a moment.  A green light flashes on, and a gray cube drops into the recess.

>take cube
You pick up the cube.

Taken.

* * *

>drop cube
Dropped.

>look
Neon's bedroom
The lights are off and there are no windows, but the room is lit well enough by the cyan glow from the terminal on Neon's desk and the blinking LEDs on the strange machine in the corner.

The desk and an adjacent workbench run along the entire length of one wall.  shelves take up the opposite wall, except for a strange machine in the corner.  In the center of the room is a bed, unmade; on either side are a nightstand and a closet door.  The bedroom door is, of course, closed behind you.

The floor is strewn with innumerable strata of dirty laundry, which is soft and nice to stand on.

The blanket strewn haphazardly across the bed bears a circuit pattern, as well as a conspicuous lump in the middle.

On the bed is nothing.

On the nightstand is nothing.

On the desk is nothing.

On the workbench is nothing.

You can also see a cube here.

>push button
The machine beeps aggressively, and a red light next to the recess flashes on.

>take cube from recess
You pick up the cube.

Taken.

>drop cube
Dropped.

>look
Neon's bedroom
The lights are off and there are no windows, but the room is lit well enough by the cyan glow from the terminal on Neon's desk and the blinking LEDs on the strange machine in the corner.

The desk and an adjacent workbench run along the entire length of one wall.  shelves take up the opposite wall, except for a strange machine in the corner.  In the center of the room is a bed, unmade; on either side are a nightstand and a closet door.  The bedroom door is, of course, closed behind you.

The floor is strewn with innumerable strata of dirty laundry, which is soft and nice to stand on.

The blanket strewn haphazardly across the bed bears a circuit pattern, as well as a conspicuous lump in the middle.

On the bed is nothing.

On the nightstand is nothing.

On the desk is nothing.

On the workbench is nothing.

You can also see two cubes here.

>take cube
You pick up the cube.

Taken.

* * *

>type star
I didn't understand that sentence.

* * *

>type foo
I didn't understand that sentence.

>help
Try typing LOOK for a description of your surroundings. Any directions indicate exits which you can use by typing WEST (or W). Some of the objects mentioned in the description might be worth a closer look with a command like EXAMINE LAUNDRY. You can also TAKE or DROP some things, type INVENTORY to see a list of what you're carrying already, OPEN or CLOSE containers or doors, and so on.

To stop these messages entirely, type NOVICE OFF.

>type foo on keypad
You carefully type on the keypad.  Unfortunately, you're not the best at spelling.  The machine buzzes and flashes a red light.

>type star on keypad
You carefully type in the one word you're absolutely sure how to spell: STAR.  The machine chirps.

>push button
The machine whirrs for a moment.  A green light flashes on, and a gray star drops into the recess.

>take star
You pick up the gray star.

Taken.

>type star anise on keypad
You type your name in.  The machine buzzes and flashes a red light.

>type anise on keypad
You type your name in.  The machine buzzes and flashes a red light.

>open closet
You open the closet door.

* * *

>open closet
You strain, but you just can't reach the doorknob from here.

>pull blanket
You tug on the blanket.  It slides off the bed and on top of you, bringing its contents with it.  A little flailing manages to kick it off of you, and you're greeted by a scowling face.

Purrl crosses her arms.  "Star Anise!!  What are you doing here!  I was taking a lovely nap, and then I had a nightmare that Star Anise woke me up, and then it wasn't a nightmare it was real!!  This is my sleep place that I found, go away!!"

You adopt an action pose, to convey how much action you're currently ready for.  "Oh!!!!!  Purrl!  I'm so glad to see you!!  Listen we're trapped in the Chamber of Despair and I've been trying to go away but I can't because of the trapped!  We gotta make a daringly cool escape!!  Do you have any explosives or maybe a cool gun."

"No!  Let me nap!!!"

"Yeah!!  A nap after we escape sounds great!!  Team Star Purrl Anise Fish Squad let's go!!"

>show panel to purrl
You point up at the panel.  "I think that opens the door!!  Also it glows a lot and I wanna touch it.  But it's too tall up!  Gimme a boost!"

Purrl puts her paws squarely on her hips.  "I'm not giving you any boots!  Find something else to stand on!!"

"Like what??  Everything in here is real big or real shirt!"  You stand on one of the dirty shirts on the floor.  "Look it doesn't make me any taller at all!  Not even one taller."

"Ugh!!  Fine."  Purrl licks her paw in a lovely manner.  "But only if you don't bother M.O.R.S.E.L."

>get on purrl
You climb awkwardly on top of Purrl.

>open closet
You grasp the doorknob in both paws and wrestle with it a bit.  It unlatches, and the door swings open!  You did it!!

>go to closet
Neon's closet (on Purrl)
You can see a closet door here.

Purrl arrives from the closet door.

* * *

>get on shelves
You make your way up the shelves.  They're too short for your helmet to fit in, so the best you can do is hold onto them like a ladder.

[on the shelves]

>x shelves
On the shelves are an award and a tiny jar of paint.

>take award
You can't hold onto the shelves and the award at the same time.

>hit award
You smack the award a few times, and it finally falls to the floor.

>hit jar
You smack the tiny jar of paint a few times, and it finally falls to the floor.

>take jar
The tiny jar of paint is too far away!  You'll have to get closer.

>down
You get off the shelves.

Neon's bedroom
The lights are off and there are no windows, but the room is lit well enough by the cyan glow from the terminal on Neon's desk and the blinking LEDs on the strange machine in the corner.

The desk and an adjacent workbench run along the entire length of one wall.  shelves take up the opposite wall, except for a strange machine in the corner.  In the center of the room is a bed, unmade; on either side are a nightstand and a closet door.  The bedroom door is, of course, closed behind you.

The floor is strewn with innumerable strata of dirty laundry, which is soft and nice to stand on.

The blanket strewn haphazardly across the bed bears a circuit pattern, as well as a conspicuous lump in the middle.

On the bed are nothing.

On the nightstand are nothing.

On the desk are nothing.

On the workbench are nothing.

You can also see a tiny jar of paint and an award here.

>paint award
I only understood you as far as wanting to do something to the tiny jar of paint.

* * *

>get on shelves
You make your way up the shelves.  They're too short for your helmet to fit in, so the best you can do is hold onto them like a ladder.

[on the shelves]

>push stuff
You methodically knock every single object off of the shelves.  While you're doing so, you take particular notice of a bag of glitter and a spool of twine.

[on the shelves]

>down
You hop down off of the shelves.

Neon's bedroom
The lights are off and there are no windows, but the room is lit well enough by the cyan glow coming from Neon's desk and the blinking LEDs on the tall machine in the corner.

The desk, with a drawer underneath, and an adjacent workbench run along the entire length of one wall.  Some shelves take up the opposite wall, stopping short of the corner to make room for a tall machine.  In the center of the room is a bed, unmade, a blanket hanging half off one side; it's framed by a nightstand and a closet door in the western wall.  The bedroom door to the east is, of course, closed.

A little white pamphlet lies on the floor near the door.

The floor is strewn with innumerable strata of dirty laundry, all of which is soft and comfortable under your paws.  Also on the floor are a bunch of stuff, a spool of twine, and a bag of glitter.

(From down here, you can't see what's on the various raised surfaces around the room.)

[on the floor]

>x bunch
Wow!  This is so much stuff!  You don't know what most of any of it is, but none of it holds your interest.

[on the floor]

>x stuff
Wow!  This is so much stuff!  You don't know what most of any of it is, but none of it holds your interest.

[on the floor]

>x bunch of stuff
Wow!  This is so much stuff!  You don't know what most of any of it is, but none of it holds your interest.

[on the floor]

>examine bunch of stuff
Wow!  This is so much stuff!  You don't know what most of any of it is, but none of it holds your interest.

[on the floor]

* * *

>hit jar
You can't see any such thing.

>climb shelves
You make your way up the shelves.  They're too short for your helmet to fit in, so the best you can do is hold onto them like a ladder.

>hit jar
You smack the tiny jar of paint a few times, and it finally falls to the floor.

>hit award
You smack the award a few times, and it finally falls to the floor.

>down
You get off the shelves.

Neon's bedroom
The lights are off and there are no windows, but the room is lit well enough by the cyan glow from the terminal on Neon's desk and the blinking LEDs on the strange machine in the corner.

The desk and an adjacent workbench run along the entire length of one wall.  shelves take up the opposite wall, except for a strange machine in the corner.  In the center of the room is a bed, unmade; on either side are a nightstand and a closet door.  The bedroom door is, of course, closed behind you.

The floor is strewn with innumerable strata of dirty laundry, which is soft and nice to stand on.

The blanket strewn haphazardly across the bed bears a circuit pattern, as well as a conspicuous lump in the middle.

On the bed is nothing.

On the nightstand is nothing.

On the desk is nothing.

On the workbench is nothing.

You can also see an award and a tiny jar of paint here.

>paint award
What do you want to paint the award with?

>decorate award
What do you want to decorate the award with?

>jar
You pour the paint all over the acrylic star and smear it around with your paws.  Soon enough, you have a moderately sticky red star, which you look at proudly.  You also have red paint all over yourself and everything nearby.  Art is easy!

[Your score has just gone up by five points.]

>look
Neon's bedroom
The lights are off and there are no windows, but the room is lit well enough by the cyan glow from the terminal on Neon's desk and the blinking LEDs on the strange machine in the corner.

The desk and an adjacent workbench run along the entire length of one wall.  shelves take up the opposite wall, except for a strange machine in the corner.  In the center of the room is a bed, unmade; on either side are a nightstand and a closet door.  The bedroom door is, of course, closed behind you.

The floor is strewn with innumerable strata of dirty laundry, which is soft and nice to stand on.

The blanket strewn haphazardly across the bed bears a circuit pattern, as well as a conspicuous lump in the middle.

On the bed is nothing.

On the nightstand is nothing.

On the desk is nothing.

On the workbench is nothing.

You can also see a red star here.

>take red star
You pick up the red star.

You pick up the red star.

* * *

>rules
Rules tracing now switched on. Type "rules off" to switch it off again, or "rules all" to include even rules which do not apply.

>look
[Rule "Smarter Parser advanced replace blank line rule" applies.]
[Rule "Numbered Disambiguation Choices strip closing parenthesis rule" applies.]
[Rule "declare everything initially unmentioned rule" applies.]
[Rule "determine visibility ceiling rule" applies.]
[Rule "announce items from multiple object lists rule" applies.]
[Rule "set pronouns from items from multiple object lists rule" applies.]
[Rule "before stage rule" applies.]
[Rule "instead stage rule" applies.]
[Rule "investigate player's awareness before action rule" applies.]
[Rule "player aware of his own actions rule" applies.]
[Rule "check stage rule" applies.]
[Rule "carry out stage rule" applies.]
[Rule "declare everything unmentioned rule" applies.]
[Rule "room description heading rule" applies.]
Neon's bedroom
[Rule "room description body text rule" applies.]
The lights are off and there are no windows, but the room is lit well enough by the cyan glow coming from Neon's desk and the blinking LEDs on the strange machine in the corner.

The desk and an adjacent workbench run along the entire length of one wall.  Some shelves take up the opposite wall, stopping short of the corner to make room for a strange machine.  In the center of the room is a bed, unmade; on either side are a nightstand and a closet door.  The bedroom door is, of course, closed behind you.

[Rule "room description paragraphs about objects rule" applies.]
[Rule "initialise locale description rule" applies.]
[Rule "find notable locale objects rule" applies.]
[Rule "standard notable locale objects rule" applies.]
[Rule "Rule for printing the locale description of a room ( called the place ) when a platform is in the place" applies.]
From the floor, you can't see what's on the various raised surfaces around the room: the bed, nightstand, desk, workbench, and shelves.

[Rule "check new arrival rule" applies.]
[Rule "mark items as seen when looking rule" applies.]
[Rule "after stage rule" applies.]
[Rule "investigate player's awareness after action rule" applies.]
[Rule "report stage rule" applies.]
[Rule "other people looking rule" applies.]
[Rule "last specific action-processing rule" applies.]
[Rule "A first turn sequence rule" applies.]
[Rule "every turn stage rule" applies.]
[Rule "A last turn sequence rule" applies.]
[Rule "notify score changes rule" applies.]

>rules off
[Rule "Smarter Parser advanced replace blank line rule" applies.]
[Rule "Numbered Disambiguation Choices strip closing parenthesis rule" applies.]
[Rule "declare everything initially unmentioned rule" applies.]
Rules tracing now switched off. Type "rules" to switch it on again.

>get on bed
You get onto the bed.

(locale description of the bed)

>down
You get off the bed.

Neon's bedroom
The lights are off and there are no windows, but the room is lit well enough by the cyan glow coming from Neon's desk and the blinking LEDs on the strange machine in the corner.

The desk and an adjacent workbench run along the entire length of one wall.  Some shelves take up the opposite wall, stopping short of the corner to make room for a strange machine.  In the center of the room is a bed, unmade; on either side are a nightstand and a closet door.  The bedroom door is, of course, closed behind you.

From the floor, you can't see what's on the various raised surfaces around the room: the bed, nightstand, desk, workbench, and shelves.

>get on bed
You get onto the bed.

(locale description of the bed)

>look
Neon's bedroom (on the bed)
The lights are off and there are no windows, but the room is lit well enough by the cyan glow coming from Neon's desk and the blinking LEDs on the strange machine in the corner.

The desk and an adjacent workbench run along the entire length of one wall.  Some shelves take up the opposite wall, stopping short of the corner to make room for a strange machine.  In the center of the room is a bed, unmade; on either side are a nightstand and a closet door.  The bedroom door is, of course, closed behind you.

From your vantage point atop the bed, you can see what's on the various other raised surfaces around the room: the nightstand, the desk, the workbench, and the shelves.
(locale description of the bed)

* * *

>showme laundry
laundry - thing
location: in Neon's bedroom
plural-named, improper-named; unlit, inedible, fixed in place, scenery, seen, familiar
list grouping key: none
printed name: "laundry"
printed plural name: none
indefinite article: none
description: "The floor is strewn with innumerable strata of dirty laundry, all of which is soft and nice to stand on."
initial appearance: none
disambiguation id: 0

* * *

>aooowwwrrr
AOOOWWWRRRR!!

>AOOWWRR
AOOOWWWRRRR!!

>aowr
AOOOWWWRRRR!!

>push button
The machine whirrs for a moment.  A green light flashes on, and a gray cube drops into the recess.

>push button
The machine beeps aggressively, and a red light next to the recess flashes on.

>x recess
In the large square recess is a gray cube.

>hit cube
You bat at the gray cube until it drops to the floor.

>actions
Actions listing on.

>hit cube
[attacking the gray cube]
[(1) pushing the gray cube]
Nothing obvious happens.
[(1) pushing the gray cube - succeeded]

[attacking the gray cube - failed]

>x recess
[examining the large square recess]
The large square recess is empty.

[examining the large square recess - succeeded]

>actions off
Actions listing off.

>push button
The machine whirrs for a moment.  A green light flashes on, and a gray cube drops into the recess.

* * *

>push button
The machine beeps aggressively, and a red light next to the recess flashes on.

>push button
The machine beeps aggressively, and a red light next to the recess flashes on.

* * *

>x recess
In the large square recess is a gray cube.

>purrl, sleep
You seem to want to talk to someone, but I can't see whom.

>pull blanket
You tug on the blanket.  It slides off the bed and on top of you, bringing its contents with it.  A little flailing manages to kick it off of you, and you're greeted by a scowling face.

Purrl crosses her arms.  "Star Anise!!  What are you doing here!  I was taking a lovely nap, and then I had a nightmare that Star Anise woke me up, and then it wasn't a nightmare it was real!!  This is my sleep place that I found, go away!!"

You adopt an action pose, to convey how much action you're currently ready for.  "Oh!!!!!  Purrl!  I'm so glad to see you!!  Listen we're trapped in the Chamber of Despair and I've been trying to go away but I can't because of the trapped!  We gotta make a daringly cool escape!!  Do you have any explosives or maybe a cool gun."

"No!  Let me nap!!!"

"Yeah!!  A nap after we escape sounds great!!  Team Star Purrl Anise Fish Squad let's go!!"

[Your score has just gone up by five points.]

>purrl, sleep
Purrl hops from foot to foot in annoyance.  "That's what I was doing before you woke me up!!!!!"

* * *

>x pamphlet
Welcome to interactive fiction!  You've already got the basics down!

The game understands basic English actions like LOOK or READ THE LITTLE WHITE PAMPHLET, as well as slightly fancier constructs like TAKE THE COOKIE FROM THE JAR, but that's as complex as it gets.  (In particular, as with most IF games, you can't use three items together at once!)

If you're not familiar with the genre, it's all about interaction: LOOK around, EXAMINE objects that stand out.  You can interact with other characters with phrasing like ASK ANDRE FOR PAINTBRUSH, or directly ask them to do something with ANDRE, READ THE PAMPHLET.

Tip: there are lots of typing shortcuts!  You can refer to this pamphlet as just LITTLE, or WHITE, or PAMPHLET.  Also, X is short for EXAMINE!

You flip through the rest of the pamphlet, which contains detailed instructions and a complete walkthrough, but there aren't any pictures!  Not one!  Worthless.

[on the floor]

>look on shelves
I only understood the first part of that-- trying anyway.

Retrying as:
>LOOK

Type UNDO if this isn't what you wanted to do, or CORRECT OFF to stop automatically correcting commands.

To stop these messages entirely, type NOVICE OFF.

Neon's bedroom
The lights are off and there are no windows, but the room is lit well enough by the cyan glow coming from Neon's desk and the blinking LEDs on the tall machine in the corner.

The desk and an adjacent workbench run along the entire length of one wall.  Some shelves take up the opposite wall, stopping short of the corner to make room for a tall machine.  In the center of the room is a bed, unmade, a blanket hanging half off one side; it's framed by a nightstand and a closet door in the western wall.  The bedroom door to the east is, of course, closed.

From down here, you can't see what's on the various raised surfaces around the room: the bed, nightstand, desk, workbench, and shelves.

The floor is strewn with innumerable strata of dirty laundry, all of which is soft and comfortable under your paws.  Also on the floor are a pamphlet, a glue stick, and a bag of glitter.

* * *

>take glue
You pick up the glue stick.

>take glitter
In your haste, you forget all about the glue stick you were holding and drop it.

You pick up the bag of glitter.

* * *

>purr
You're overcome by sheer delight for life and all its adventures, and you purr about it for a while.

>take blanket
You tug on the blanket.  It slides off the bed and on top of you, bringing its contents with it.  A little flailing manages to kick it off of you, and you're greeted by a scowling face.

Purrl crosses her arms.  "Star Anise!!  What are you doing here!  I was taking a lovely nap, and then I had a nightmare that Star Anise woke me up, and then it wasn't a nightmare it was real!!  This is my sleep place that I found, go away!!"

You adopt an action pose, to convey how much action you're currently ready for.  "Oh!!!!!  Purrl!  I'm so glad to see you!!  Listen we're trapped in the Chamber of Despair and I've been trying to go away but I can't because of the trapped!  We gotta make a daringly cool escape!!  Do you have any explosives or maybe a cool gun."

"No!  Let me nap!!!"

"Yeah!!  A nap after we escape sounds great!!  Team Star Purrl Anise Fish Squad let's go!!"

[Your score has just gone up by five points.]

>z
Time passes.

>z
Time passes.

Purrl gently pokes the blanket.

* * *

>jump
You jump on the spot.

>jump on bed
You get onto the bed.

The blanket strewn haphazardly across the bed bears a circuit pattern that matches the pillow, as well as a conspicuous lump in the middle.

>pull blanket
You reel the blanket towards you with your little pest paws, and it slides away from the lump to reveal Purrl.  She hops to her feet, bewildered, but her expression darkens when she notices you.

Purrl crosses her arms.  "Star Anise!!  What are you doing here!  I was taking a lovely nap, and then I had a nightmare that Star Anise woke me up, and then it wasn't a nightmare it was real!!  This is my sleep place that I found, go away!!"

You adopt an action pose, to convey how much action you're currently ready for.  "Oh!!!!!  Purrl!  I'm so glad to see you!!  Listen we're trapped in the Chamber of Despair and I've been trying to go away but I can't because of the trapped!  We gotta make a daringly cool escape!!  Do you have any explosives or maybe a cool gun."

"No!  Let me nap!!!"

"Yeah!!  A nap after we escape sounds great!!  Team Star Purrl Anise Fish Squad let's go!!"

[Your score has just gone up by five points.]

>z
Time passes.

>z
Time passes.

Purrl gets off the bed.

* * *

>get on workbench
You get onto the workbench.

A broad flat plain stretches out in front of you.

On the workbench you can see a mug, a construction paper, and some scissors.

>undo
Neon's bedroom
[Previous turn undone.]

* * *

>activities
[Rule "Smarter Parser advanced replace blank line rule" applies.]
[Rule "Numbered Disambiguation Choices strip closing parenthesis rule" applies.]
[Rule "After reading a command" applies.]
[Rule "Rule for deciding the concealed possessions of a platform" applies.]
[Rule "Rule for deciding the concealed possessions of a platform" applies.]
[Rule "Rule for deciding the concealed possessions of the blanket" applies.]
[Rule "Rule for deciding the concealed possessions of a platform" applies.]
[Rule "Rule for deciding the concealed possessions of a platform" applies.]
[Rule "Rule for deciding the concealed possessions of a platform" applies.]
[Rule "Rule for deciding the concealed possessions of a platform" applies.]
[Rule "Rule for deciding the concealed possessions of a platform" applies.]
[Rule "Rule for deciding the concealed possessions of a platform" applies.]
[Rule "Rule for deciding the concealed possessions of a platform" applies.]
[Rule "Rule for deciding the concealed possessions of a platform" applies.]
[Rule "Smarter Parser trying harder to understand rule" applies.]
[Rule "stripping punctuation rule" applies.]
[Rule "fast stripping punctuation rule" applies.]
[Rule "simplify contractions rule" applies.]
[Rule "standardize can verbs rule" applies.]
[Rule "where can I go rule" applies.]
[Rule "signs of confusion rule" applies.]
[Rule "stripping niceties rule" applies.]
[Rule "stripping interjections rule" applies.]
[Rule "standardize be verbs rule" applies.]
[Rule "asking who are you rule" applies.]
[Rule "asking who am i rule" applies.]
[Rule "asking where am i rule" applies.]
[Rule "stripping verbose intro rule" applies.]
[Rule "asking unparseable questions rule" applies.]
[Rule "stripping adverbs rule" applies.]
[Rule "making assertions rule" applies.]
[Rule "unnecessary movement rule" applies.]
[Rule "stripping vague words rule" applies.]
[Rule "stripping pointless words rule" applies.]
[Rule "stripping failed with rule" applies.]
[Rule "no gerunds rule" applies.]
[Rule "unnecessary possessives rule" applies.]
[Rule "stripping unnecessary addendum rule" applies.]
[Rule "failed communication attempts rule" applies.]
[Rule "too many words rule" applies.]
[Rule "fix the command rule" applies.]
That's not a verb I recognize.

* * *

>get on workbench
You get onto the workbench.

A broad flat plain stretches out in front of you.

On the workbench you can see a mug, a construction paper, and some scissors.

>get on bed
The bed is too far away!  You'll have to get closer.

>down
You hop down off of the workbench.

Neon's bedroom
The lights are off and there are no windows, but the room is lit well enough by the cyan glow coming from Neon's desk and the blinking LEDs on the tall machine in the corner.

The desk and an adjacent workbench run along the entire length of one wall.  Some shelves take up the opposite wall, stopping short of the corner to make room for a tall machine.  In the center of the room is a bed, unmade, a blanket hanging half off one side; it's framed by a nightstand and a closet door in the western wall.  The bedroom door to the east is, of course, closed.

From down here, you can't see what's on the various raised surfaces around the room: the bed, nightstand, desk, workbench, and shelves.

A little white pamphlet lies on the floor near the door.

The floor is strewn with innumerable strata of dirty laundry, all of which is soft and comfortable under your paws.  Also on the floor are a glue stick and a bag of glitter.

>get on bed
You get onto the bed.

The blanket strewn haphazardly across the bed bears a circuit pattern that matches the pillow, as well as a conspicuous lump in the middle.

>look
Neon's bedroom (on the bed)
The lights are off and there are no windows, but the room is lit well enough by the cyan glow coming from Neon's desk and the blinking LEDs on the tall machine in the corner.

The desk and an adjacent workbench run along the entire length of one wall.  Some shelves take up the opposite wall, stopping short of the corner to make room for a tall machine.  In the center of the room is a bed, unmade, a blanket hanging half off one side; it's framed by a nightstand and a closet door in the western wall.  The bedroom door to the east is, of course, closed.

From your vantage point atop the bed, you could see what's on the various other raised surfaces around the room (the nightstand, desk, workbench, and shelves), if you cared to take a look.

A little white pamphlet lies on the floor near the door.

The floor is strewn with innumerable strata of dirty laundry, all of which is soft and comfortable under your paws.  Also on the floor are a glue stick and a bag of glitter.

The blanket strewn haphazardly across the bed bears a circuit pattern that matches the pillow, as well as a conspicuous lump in the middle.

* * *

>get on workbench
You get onto the workbench.

A broad flat plain stretches out in front of you.

On the workbench you can see a mug, a construction paper, and some scissors.

>look
Neon's bedroom (on the workbench)
The lights are off and there are no windows, but the room is lit well enough by the cyan glow coming from Neon's desk and the blinking LEDs on the tall machine in the corner.

The desk and an adjacent workbench run along the entire length of one wall.  Some shelves take up the opposite wall, stopping short of the corner to make room for a tall machine.  In the center of the room is a bed, unmade, a blanket hanging half off one side; it's framed by a nightstand and a closet door in the western wall.  The bedroom door to the east is, of course, closed.

A little white pamphlet lies on the floor near the door.

The floor is strewn with innumerable strata of dirty laundry, all of which is soft and comfortable under your paws.  Also on the floor are a glue stick and a bag of glitter.

(From your vantage point atop the workbench, you can get a better look at the various other raised surfaces around the room.)

A broad flat plain stretches out in front of you.

On the workbench you can see a mug, some construction paper, and some scissors.

>x bed
This big cat bed is for the big cat.  Sometimes she shares it with you, but only if she's asleep already.

On the bed are a pillow and a blanket.

>down
You hop down off of the workbench.

Neon's bedroom
The lights are off and there are no windows, but the room is lit well enough by the cyan glow coming from Neon's desk and the blinking LEDs on the tall machine in the corner.

The desk and an adjacent workbench run along the entire length of one wall.  Some shelves take up the opposite wall, stopping short of the corner to make room for a tall machine.  In the center of the room is a bed, unmade, a blanket hanging half off one side; it's framed by a nightstand and a closet door in the western wall.  The bedroom door to the east is, of course, closed.

A little white pamphlet lies on the floor near the door.

The floor is strewn with innumerable strata of dirty laundry, all of which is soft and comfortable under your paws.  Also on the floor are a glue stick and a bag of glitter.

(From down here, you can't see what's on the various raised surfaces around the room.)

>x bed
This big cat bed is for the big cat.  Sometimes she shares it with you, but only if she's asleep already.

You can't see what's on the bed from here, though hanging over the edge is a blanket.

>down
You can't go that way.

The only way to go is west.

>get on workbench
You get onto the workbench.

A broad flat plain stretches out in front of you.

On the workbench you can see a mug, some construction paper, and some scissors.

>push scissors off workbench
You can't see any such thing.

>push scissors
Nothing obvious happens.

>take scissors
You pick up the scissors.

>throw scissors
Dropped.

>take scissors
You pick up the scissors.

>down
You hop down off of the workbench.

Neon's bedroom
The lights are off and there are no windows, but the room is lit well enough by the cyan glow coming from Neon's desk and the blinking LEDs on the tall machine in the corner.

The desk and an adjacent workbench run along the entire length of one wall.  Some shelves take up the opposite wall, stopping short of the corner to make room for a tall machine.  In the center of the room is a bed, unmade, a blanket hanging half off one side; it's framed by a nightstand and a closet door in the western wall.  The bedroom door to the east is, of course, closed.

A little white pamphlet lies on the floor near the door.

The floor is strewn with innumerable strata of dirty laundry, all of which is soft and comfortable under your paws.  Also on the floor are a glue stick and a bag of glitter.

(From down here, you can't see what's on the various raised surfaces around the room.)

>x bedroom
Neon's bedroom
The lights are off and there are no windows, but the room is lit well enough by the cyan glow coming from Neon's desk and the blinking LEDs on the tall machine in the corner.

The desk and an adjacent workbench run along the entire length of one wall.  Some shelves take up the opposite wall, stopping short of the corner to make room for a tall machine.  In the center of the room is a bed, unmade, a blanket hanging half off one side; it's framed by a nightstand and a closet door in the western wall.  The bedroom door to the east is, of course, closed.

A little white pamphlet lies on the floor near the door.

The floor is strewn with innumerable strata of dirty laundry, all of which is soft and comfortable under your paws.  Also on the floor are a glue stick and a bag of glitter.

(From down here, you can't see what's on the various raised surfaces around the room.)

>throw scissors at bedroom
Futile.

>actions
Actions listing on.

>throw scissors at bedroom
[throwing the scissors at the bedroom door]
Futile.
[throwing the scissors at the bedroom door - failed the futile to throw things at inanimate objects rule]

>x bedroom
[overly elaborate looking Neon's bedroom]
[(1) looking]
Neon's bedroom
The lights are off and there are no windows, but the room is lit well enough by the cyan glow coming from Neon's desk and the blinking LEDs on the tall machine in the corner.

The desk and an adjacent workbench run along the entire length of one wall.  Some shelves take up the opposite wall, stopping short of the corner to make room for a tall machine.  In the center of the room is a bed, unmade, a blanket hanging half off one side; it's framed by a nightstand and a closet door in the western wall.  The bedroom door to the east is, of course, closed.

A little white pamphlet lies on the floor near the door.

The floor is strewn with innumerable strata of dirty laundry, all of which is soft and comfortable under your paws.  Also on the floor are a glue stick and a bag of glitter.

(From down here, you can't see what's on the various raised surfaces around the room.)

[(1) looking - succeeded]

[overly elaborate looking Neon's bedroom - succeeded]

>actions off
Actions listing off.

* * *

>get on workbench
You get onto the workbench.

A broad flat plain stretches out in front of you.

On the workbench you can see a mug, a construction paper, and some scissors.

>push scissors
You bat at the scissors a few times, and they finally drop to the floor.

>push mug
You bat at the mug a few times, and it finally drops to the floor.

>push paper
You bat at the construction paper a few times, and they finally drop to the floor.

>showme paper
(the construction paper)
construction paper - thing
location: in Neon's bedroom
plural-named, improper-named; unlit, inedible, portable, seen, familiar
list grouping key: none
printed name: "construction paper"
printed plural name: none
indefinite article: none
description: "This paper is a deep alluring blue, perfect for arts and crafts.  It's only too bad someone already drew a bunch of white lines all over it."
initial appearance: none
disambiguation id: 0

>take paper
The construction paper are too far away!  You'll have to get closer.

* * *

>get on workbench
You get onto the workbench.

A broad flat plain stretches out in front of you.

On the workbench you can see a mug, a construction paper, and some scissors.

>push mug
You bat at the mug a few times, and it finally drops to the floor.

The laundry cushioned its fall, but the mug didn't survive unscathed.  It's now chipped.

>down
You hop down off of the workbench.

Neon's bedroom
The lights are off and there are no windows, but the room is lit well enough by the cyan glow coming from Neon's desk and the blinking LEDs on the tall machine in the corner.

The desk and an adjacent workbench run along the entire length of one wall.  Some shelves take up the opposite wall, stopping short of the corner to make room for a tall machine.  In the center of the room is a bed, unmade, a blanket hanging half off one side; it's framed by a nightstand and a closet door in the western wall.  The bedroom door to the east is, of course, closed.

A little white pamphlet lies on the floor near the door.

The floor is strewn with innumerable strata of dirty laundry, all of which is soft and comfortable under your paws.  Also on the floor are a chipped mug, a glue stick, and a bag of glitter.

(From down here, you can't see what's on the various raised surfaces around the room.)

>test shop
(Testing.)

>[1] pull blanket
You tug on the blanket.  It slides off the bed and on top of you, bringing its contents with it.  A little flailing manages to kick it off of you, and you're greeted by a scowling face.

Purrl crosses her arms.  "Star Anise!!  What are you doing here!  I was taking a lovely nap, and then I had a nightmare that Star Anise woke me up, and then it wasn't a nightmare it was real!!  This is my sleep place that I found, go away!!"

You adopt an action pose, to convey how much action you're currently ready for.  "Oh!!!!!  Purrl!  I'm so glad to see you!!  Listen we're trapped in the Chamber of Despair and I've been trying to go away but I can't because of the trapped!  We gotta make a daringly cool escape!!  Do you have any explosives or maybe a cool gun."

"No!  Let me nap!!!"

"Yeah!!  A nap after we escape sounds great!!  Team Star Purrl Anise Fish Squad let's go!!"

[Your score has just gone up by five points.]

>[2] show panel to purrl
You point up at the panel.  "I think that opens the door!!  Also it glows a lot and I wanna touch it.  But it's too tall up!  Gimme a boost!"

Purrl puts her paws squarely on her hips.  "I'm not giving you any boots!  Find something else to stand on!!"

"Like what??  Everything in here is real big or real shirt!"  You stand on one of the dirty shirts on the floor.  "Look it doesn't make me any taller at all!  Not even one taller!!  I can't escape like this!"

"Mmmmnnmnnmmnnnn.  I dunno."  Purrl licks her paw in a lovely manner.  "But okay.  But only if you don't bother M.O.R.S.E.L."

[Your score has just gone up by five points.]

>[3] climb purrl
You climb awkwardly on top of Purrl's helmet.

>[4] touch panel
You try this a couple times, but to no avail.  "It didn't work!!  Let me out you dumb lights thing!!"

Purrl frowns up at your butt.  "Can I go do more nap now?"

"No!!!  I have a new idea!!"  You hop down off Purrl's helmet and kick some laundry around, making a clearing on the floor.  "It's time to open Star Anise shop!!  It's the only way!!!!"

"I don't care about Star Anise shop!!!!"  Purrl takes out her frustrations by helping you kick laundry.

[Your score has just gone up by five points.]

>take mug
You pick up the chipped mug.

>climb purrl
You climb awkwardly on top of Purrl's helmet.

>put mug on workbench
You put the chipped mug on the workbench.

Purrl sighs dramatically.

>push mug
The mug is too far away!  You'll have to get closer.

Purrl bats at her antenna.

>get on workbench
Purrl frowns and shakes her head.  "I'm just giving you boots, Star Anise!!  I'm not carrying you around like a horse!  Don't horse me!!"

>down
You hop down off of Purrl.
Neon's bedroom
The lights are off and there are no windows, but the room is lit well enough by the cyan glow coming from Neon's desk and the blinking LEDs on the tall machine in the corner.

The desk and an adjacent workbench run along the entire length of one wall.  Some shelves take up the opposite wall, stopping short of the corner to make room for a tall machine.  In the center of the room is a bed; it's framed by a nightstand and a closet door in the western wall.  The bedroom door to the east is, of course, closed.

Your new shop is taking shape!  So far, that shape is a clearing on the floor.

A little white pamphlet lies on the floor near the door.

The floor is strewn with innumerable strata of dirty laundry, all of which is soft and comfortable under your paws.  Purrl has found a nice shirt to wrap around herself.  Also on the floor are a blanket, a glue stick, and a bag of glitter.

(From down here, you can't see what's on the various raised surfaces around the room.)

>get on workbench
You get onto the workbench.

A broad flat plain stretches out in front of you.

On the workbench you can see a chipped mug, a construction paper, and some scissors.

>push mug
You bat at the mug a few times, and it finally drops to the floor.

The laundry cushioned its fall, but the mug didn't survive unscathed.  It's now cracked.

>down
You hop down off of the workbench.

Neon's bedroom
The lights are off and there are no windows, but the room is lit well enough by the cyan glow coming from Neon's desk and the blinking LEDs on the tall machine in the corner.

The desk and an adjacent workbench run along the entire length of one wall.  Some shelves take up the opposite wall, stopping short of the corner to make room for a tall machine.  In the center of the room is a bed; it's framed by a nightstand and a closet door in the western wall.  The bedroom door to the east is, of course, closed.

Your new shop is taking shape!  So far, that shape is a clearing on the floor.

A little white pamphlet lies on the floor near the door.

The floor is strewn with innumerable strata of dirty laundry, all of which is soft and comfortable under your paws.  Purrl has found a nice shirt to wrap around herself.  Also on the floor are a cracked mug, a blanket, a glue stick, and a bag of glitter.

(From down here, you can't see what's on the various raised surfaces around the room.)

Purrl wanders around.

>take mug
You pick up the cracked mug.

>climb on purrl
You climb awkwardly on top of Purrl's helmet.

>put mug on workbench
You put the cracked mug on the workbench.

Purrl clears her throat loudly.

>down
You hop down off of Purrl.
Neon's bedroom
The lights are off and there are no windows, but the room is lit well enough by the cyan glow coming from Neon's desk and the blinking LEDs on the tall machine in the corner.

The desk and an adjacent workbench run along the entire length of one wall.  Some shelves take up the opposite wall, stopping short of the corner to make room for a tall machine.  In the center of the room is a bed; it's framed by a nightstand and a closet door in the western wall.  The bedroom door to the east is, of course, closed.

Your new shop is taking shape!  So far, that shape is a clearing on the floor.

A little white pamphlet lies on the floor near the door.

The floor is strewn with innumerable strata of dirty laundry, all of which is soft and comfortable under your paws.  Purrl has found a nice shirt to wrap around herself.  Also on the floor are a blanket, a glue stick, and a bag of glitter.

(From down here, you can't see what's on the various raised surfaces around the room.)

>get on workbench
You get onto the workbench.

A broad flat plain stretches out in front of you.

On the workbench you can see a cracked mug, a construction paper, and some scissors.

>push mug
You bat at the mug a few times, and it finally drops to the floor.

It put on a brave face, but the mug finally shatters.

>down. take mug. get on purrl. put mug on workbench. down. get on workbench. push mug
You hop down off of the workbench.

Neon's bedroom
The lights are off and there are no windows, but the room is lit well enough by the cyan glow coming from Neon's desk and the blinking LEDs on the tall machine in the corner.

The desk and an adjacent workbench run along the entire length of one wall.  Some shelves take up the opposite wall, stopping short of the corner to make room for a tall machine.  In the center of the room is a bed; it's framed by a nightstand and a closet door in the western wall.  The bedroom door to the east is, of course, closed.

Your new shop is taking shape!  So far, that shape is a clearing on the floor.

A little white pamphlet lies on the floor near the door.

The floor is strewn with innumerable strata of dirty laundry, all of which is soft and comfortable under your paws.  Purrl has found a nice shirt to wrap around herself.  Also on the floor are a broken mug, a blanket, a glue stick, and a bag of glitter.

(From down here, you can't see what's on the various raised surfaces around the room.)

Purrl blows some bubbles in her helmet.

You pick up the broken mug.

You climb awkwardly on top of Purrl's helmet.

You put the broken mug on the workbench.

Purrl bats at her antenna.

You hop down off of Purrl.Neon's bedroom
The lights are off and there are no windows, but the room is lit well enough by the cyan glow coming from Neon's desk and the blinking LEDs on the tall machine in the corner.

The desk and an adjacent workbench run along the entire length of one wall.  Some shelves take up the opposite wall, stopping short of the corner to make room for a tall machine.  In the center of the room is a bed; it's framed by a nightstand and a closet door in the western wall.  The bedroom door to the east is, of course, closed.

Your new shop is taking shape!  So far, that shape is a clearing on the floor.

A little white pamphlet lies on the floor near the door.

The floor is strewn with innumerable strata of dirty laundry, all of which is soft and comfortable under your paws.  Purrl has found a nice shirt to wrap around herself.  Also on the floor are a blanket, a glue stick, and a bag of glitter.

(From down here, you can't see what's on the various raised surfaces around the room.)

You get onto the workbench.

A broad flat plain stretches out in front of you.

On the workbench you can see a broken mug, a construction paper, and some scissors.

>showme mug
broken mug - thing
location: on the workbench in Neon's bedroom
singular-named, improper-named; unlit, inedible, portable, handled, seen, familiar
list grouping key: none
printed name: "mug"
printed plural name: none
indefinite article: none
description: "These pieces used to be a single mug.  Now they're a lot of small toys, which is much better.
"
initial appearance: none
disambiguation id: 0
damage level: broken

* * *

>put glue on workbench
You can't reach the workbench from here.

>throw glue onto workbench
You can't reach the workbench from here.

>actions
Actions listing on.

>throw glue onto workbench
[putting the glue stick on the workbench]
You can't reach the workbench from here.
[putting the glue stick on the workbench - failed the Check putting something on a platform ( called the shelf )]

>throw glue at workbench
[throwing the glue stick at the workbench]
(first taking the glue stick)
[(1) taking the glue stick - silently]
[(1) taking the glue stick - silently - succeeded]

The glue stick sails in a high arc through the air and lands more or less on the workbench.
[throwing the glue stick at the workbench - succeeded]

>get on workbench
I only understood the first part of that-- trying anyway.

Retrying as:
>GET ON

Type UNDO if this isn't what you wanted to do, or CORRECT OFF to stop automatically correcting commands.

To stop these messages entirely, type NOVICE OFF.

[entering the bed]
You can't climb very well with your hands full.  "AOOWWRR!" you wail in despair.
[entering the bed - failed]

>x workbench
You can't see any such thing.

>actions off
Actions listing off.

>look
Neon's bedroom
The lights are off and there are no windows, but the room is lit well enough by the cyan glow coming from Neon's desk and the blinking LEDs on the tall machine in the corner.

The desk and an adjacent workbench run along the entire length of one wall.  Some shelves take up the opposite wall, stopping short of the corner to make room for a tall machine.  In the center of the room is a bed, unmade, a blanket hanging half off one side; it's framed by a nightstand and a closet door in the western wall.  The bedroom door to the east is, of course, closed.

A little white pamphlet lies on the floor near the door.

The floor is strewn with innumerable strata of dirty laundry, all of which is soft and comfortable under your paws.  Also on the floor is a bag of glitter.

(From down here, you can't see what's on the various raised surfaces around the room.)

>scope
1: a closet door (722581)
2: a doorknob (722613)
3: yourself (721781)
4: a laundry (721813)
5: a bedroom door (721845)
6: a glowing panel (722453)
7: a pamphlet (721877)
8: a bed (721909)
9: a blanket (721973)
10: a nightstand (722005)
11: a desk (722069)
12: some shelves (722261)
13: a tall machine (722357)
14: some lights (722837)
15: a keypad (722869)
16: a red button (722901)
17: a large square slot (722933)
18: a Lily figurine (722965)
19: a bag of glitter (722421)
20: a glue stick (722389)

>showme workbench
workbench - platform
    mug
    construction paper
    scissors
location: the glue stick carried by yourself in Neon's bedroom
singular-named, improper-named; unlit, inedible, fixed in place, seen, familiar; enterable
list grouping key: none
printed name: "workbench"
printed plural name: "platforms"
indefinite article: none
description: none
initial appearance: "A broad flat plain stretches out in front of you."
disambiguation id: 0
carrying capacity: 100

* * *

>x me
You are Star Anise, a luneko and a cool guy who love to party.  The stars inside your helmet twinkle extra-hard as you think about how much you love to party.

[on the floor]

>x east
You see nothing unexpected in that direction.

[on the floor]

>party
Yeah!  Let's get this party started!  You do a little dance.

[on the floor]

* * *

>x me
You are Star Anise, a luneko and a cool guy who love to party.  The stars inside your helmet twinkle extra-hard as you think about how much you love to party.

[on the floor]

>search laundry
You toss some clothes in the air and generally have a great time.

Oh!  You spot something shiny under a jacket and dig it out.  It's a yellow star!

[Your score has just gone up by three points.]

[on the floor]

>x star
This star has too many points, but it's still a pretty good star.  It's metal and shiny and says "FFIREHS" in embossed letters.  All very good qualities, even if that's not a word and they got some of the letters upside-down.

[on the floor]

>get on purrl
I only understood the first part of that-- trying anyway.

Retrying as:
>GET ON

Type UNDO if this isn't what you wanted to do, or CORRECT OFF to stop automatically correcting commands.

To stop these messages entirely, type NOVICE OFF.

You get onto the bed.

The blanket laying haphazardly across the bed bears a circuit pattern that matches the pillow, as well as a conspicuous lump in the middle.

[on the bed]

* * *

>search shelves
On the shelves is nothing.

>search stuff
You can't see any such thing.

>look
Neon's bedroom
The lights are off and there are no windows, but the room is lit well enough by the cyan glow coming from Neon's desk and the blinking LEDs on the tall machine in the corner.

The desk and an adjacent workbench run along the entire length of one wall.  Some shelves take up the opposite wall, stopping short of the corner to make room for a tall machine.  In the center of the room is a bed, unmade, a blanket hanging half off one side; it's framed by a nightstand and a closet door in the western wall.  The bedroom door to the east is, of course, closed.

A little white pamphlet lies on the floor near the door.

The floor is strewn with innumerable strata of dirty laundry, all of which is soft and comfortable under your paws.

(From down here, you can't see what's on the various raised surfaces around the room.)

>x shelves
You see nothing special about the shelves.

You can't see what's on the shelves from here.

>search shelves
On the shelves is nothing.

>i
Your paws are empty.

>search stuff
You can't see any such thing.

>climb shelves
You make your way up the shelves.  They're too short for your helmet to fit in, so the best you can do is hold onto them like a ladder.

>look
Neon's bedroom (on the shelves)
The lights are off and there are no windows, but the room is lit well enough by the cyan glow coming from Neon's desk and the blinking LEDs on the tall machine in the corner.

The desk and an adjacent workbench run along the entire length of one wall.  Some shelves take up the opposite wall, stopping short of the corner to make room for a tall machine.  In the center of the room is a bed, unmade, a blanket hanging half off one side; it's framed by a nightstand and a closet door in the western wall.  The bedroom door to the east is, of course, closed.

A little white pamphlet lies on the floor near the door.

The floor is strewn with innumerable strata of dirty laundry, all of which is soft and comfortable under your paws.

(From your vantage point atop the shelves, you can get a better look at the various other raised surfaces around the room.)

On the shelves you can see a bunch of stuff.

* * *

>climb shelves
You make your way up the shelves.  They're too short for your helmet to fit in, so the best you can do is hold onto them like a ladder.

[on the shelves]

>look
Neon's bedroom (on the shelves)
The lights are off and there are no windows, but the room is lit well enough by the cyan glow coming from Neon's desk and the blinking LEDs on the tall machine in the corner.

The desk and an adjacent workbench run along the entire length of one wall.  Some shelves take up the opposite wall, stopping short of the corner to make room for a tall machine.  In the center of the room is a bed, unmade, a blanket hanging half off one side; it's framed by a nightstand and a closet door in the western wall.  The bedroom door to the east is, of course, closed.

A little white pamphlet lies on the floor near the door.

The floor is strewn with innumerable strata of dirty laundry, all of which is soft and comfortable under your paws.

(From your vantage point atop the shelves, you can get a better look at the various other raised surfaces around the room.)

These shelves run all the way to the ceiling and are absolutely jam-packed with a whole bunch of stuff.

>x shelves
On the shelves is a bunch of stuff.

>x stuff
Wow!  This is so much stuff!  You don't know what most of any of it is, and you can't tell at a quick glance if any of it is interesting.

>knock stuff down
You methodically knock every single object off of the shelves.  While you're doing so, you take particular notice of a bag of glitter and a spool of twine.

>look
Neon's bedroom (on the shelves)
The lights are off and there are no windows, but the room is lit well enough by the cyan glow coming from Neon's desk and the blinking LEDs on the tall machine in the corner.

The desk and an adjacent workbench run along the entire length of one wall.  Some shelves take up the opposite wall, stopping short of the corner to make room for a tall machine.  In the center of the room is a bed, unmade, a blanket hanging half off one side; it's framed by a nightstand and a closet door in the western wall.  The bedroom door to the east is, of course, closed.

A little white pamphlet lies on the floor near the door.

The floor is strewn with innumerable strata of dirty laundry, all of which is soft and comfortable under your paws.  Also on the floor are a bunch of stuff, a spool of twine, and a bag of glitter.

(From your vantage point atop the shelves, you can get a better look at the various other raised surfaces around the room.)

These shelves run all the way to the ceiling but have been laid pretty much bare.

* * *

>climb shelves
You make your way up the shelves.  They're too short for your helmet to fit in, so the best you can do is hold onto them like a ladder.

[on the shelves]

>search stuff
Oh!  You spot a bag of glitter!

[Your score has just gone up by one point.]

>look
Neon's bedroom (on the shelves)
The lights are off and there are no windows, but the room is lit well enough by the cyan glow coming from Neon's desk and the blinking LEDs on the tall machine in the corner.

The desk and an adjacent workbench run along the entire length of one wall.  Some shelves take up the opposite wall, stopping short of the corner to make room for a tall machine.  In the center of the room is a bed, unmade, a blanket hanging half off one side; it's framed by a nightstand and a closet door in the western wall.  The bedroom door to the east is, of course, closed.

A little white pamphlet lies on the floor near the door.

The floor is strewn with innumerable strata of dirty laundry, all of which is soft and comfortable under your paws.

(From your vantage point atop the shelves, you can get a better look at the various other raised surfaces around the room.)

These shelves run all the way to the ceiling and are absolutely jam-packed with a whole bunch of stuff.

On the shelves you can see a bag of glitter.

>swipe stuff down
That's not a verb I recognize.

>bat stuff down
That's not a verb I recognize.

* * *

>climb shelves
You make your way up the shelves.  They're too short for your helmet to fit in, so the best you can do is hold onto them like a ladder.

[on the shelves]

>drop shelves
You haven't got those.

[on the shelves]

* * *

>look
Neon's bedroom
The lights are off and there are no windows, but the room is lit well enough by the cyan glow coming from Neon's desk and the blinking LEDs on the tall machine in the corner.

The desk and an adjacent workbench run along the entire length of one wall.  Some shelves take up the opposite wall, stopping short of the corner to make room for a tall machine.  In the center of the room is a bed, unmade, a blanket hanging half off one side; it's framed by a nightstand and a closet door in the western wall.  The bedroom door to the east is, of course, closed.

A little white pamphlet lies on the floor near the door.

The floor is strewn with innumerable strata of dirty laundry, all of which is soft and comfortable under your paws.

(From down here, you can't see what's on the various raised surfaces around the room.)

[on the floor]

>get on bed
You get onto the bed.

The blanket laying haphazardly across the bed bears a circuit pattern that matches the pillow, as well as a conspicuous lump in the middle.

[on the floor]

>wait
Time passes.

[on the floor]

>showme me
yourself - person
location: on the bed in Neon's bedroom
singular-named, proper-named; unlit, inedible, portable, seen, familiar; male
list grouping key: none
printed name: "yourself"
printed plural name: "people"
indefinite article: none
description: "You are Star Anise, a luneko and a cool guy who love to party.  The stars inside your helmet twinkle extra-hard as you think about how much you love to party."
initial appearance: none
disambiguation id: 0
illustration: Figure Star Anise
carrying capacity: 1

[on the floor]

>pull blanket
You reel the blanket towards you with your little pest paws, and it slides away from the lump to reveal Purrl.  She hops to her feet, bewildered, but her expression darkens when she notices you.

Purrl crosses her arms.  "Star Anise!!  What are you doing here!  I was taking a lovely nap, and then I had a nightmare that Star Anise woke me up, and then it wasn't a nightmare it was real!!  This is my sleep place that I found, go away!!"

You adopt an action pose, to convey how much action you're currently ready for.  "Oh!!!!!  Purrl!  I'm so glad to see you!!  Listen we're trapped in the Chamber of Despair and I've been trying to go away but I can't because of the trapped!  We gotta make a daringly cool escape!!  Do you have any explosives or maybe a cool gun."

"No!  Let me nap!!!"

"Yeah!!  A nap after we escape sounds great!!  Team Star Purrl Anise Fish Squad let's go!!"

Purrl hops down off of the bed.

[Your score has just gone up by five points.]

[on the floor]

>down
You hop down off of the bed.

Neon's bedroom
The lights are off and there are no windows, but the room is lit well enough by the cyan glow coming from Neon's desk and the blinking LEDs on the tall machine in the corner.

The desk and an adjacent workbench run along the entire length of one wall.  Some shelves take up the opposite wall, stopping short of the corner to make room for a tall machine.  In the center of the room is a bed, unmade, a blanket hanging half off one side; it's framed by a nightstand and a closet door in the western wall.  The bedroom door to the east is, of course, closed.

A little white pamphlet lies on the floor near the door.

The floor is strewn with innumerable strata of dirty laundry, all of which is soft and comfortable under your paws.  Purrl has found a nice shirt to wrap around herself.

(From down here, you can't see what's on the various raised surfaces around the room.)

[on the floor]

>get on purrl
"Don't step on me Star Anise!!"  Purrl grumbles and pushes you away.  You try to explain that you need to be taller, but she isn't swayed.  If only you had a more concrete excuse...

[on the floor]

>show panel
(to Purrl)
You point up at the panel.  "I think that opens the door!!  Also it glows a lot and I wanna touch it.  But it's too tall up!  Gimme a boost!"

Purrl puts her paws squarely on her hips.  "I'm not giving you any boots!  Find something else to stand on!!"

"Like what??  Everything in here is real big or real shirt!"  You stand on one of the dirty shirts on the floor.  "Look it doesn't make me any taller at all!  Not even one taller!!  I can't escape like this!"

"Mmmmnnmnnmmnnnn.  I dunno."  Purrl licks her paw in a lovely manner.  "But okay.  But only if you don't bother M.O.R.S.E.L."

[Your score has just gone up by five points.]

[on the floor]

>get on purrl
Purrl reluctantly leans down for you, and you clamber awkwardly on top of her helmet.

[on the floor]

>down
You hop down off of Purrl.
Neon's bedroom
The lights are off and there are no windows, but the room is lit well enough by the cyan glow coming from Neon's desk and the blinking LEDs on the tall machine in the corner.

The desk and an adjacent workbench run along the entire length of one wall.  Some shelves take up the opposite wall, stopping short of the corner to make room for a tall machine.  In the center of the room is a bed, unmade, a blanket hanging half off one side; it's framed by a nightstand and a closet door in the western wall.  The bedroom door to the east is, of course, closed.

A little white pamphlet lies on the floor near the door.

The floor is strewn with innumerable strata of dirty laundry, all of which is soft and comfortable under your paws.  Purrl has found a nice shirt to wrap around herself.

(From down here, you can't see what's on the various raised surfaces around the room.)

[on the floor]

>take blanket
You pick up the blanket.

Purrl gently pokes the little white pamphlet.

[on the floor]

* * *

>get on desk
You get onto the desk.

The metal desk is surprisingly sparse, occupied mainly by a glowing terminal.  You miss when it was covered in documents that you could freely scatter everywhere, but for some reason, the big cat started putting them away somewhere.

On the desk you can see an award.

[on the desk]

>purloin mug
[Purloined.]

[on the desk]

>drop mug
Dropped.

[on the desk]

>push mug
You bat at the mug a few times, and it finally drops to the floor.

The laundry cushioned its fall, but the mug didn't survive unscathed.  It's now chipped.

[on the desk]

>purloin mug. drop mug. push mug
[Purloined.]

Dropped.

You bat at the mug a few times, and it finally drops to the floor.

The laundry cushioned its fall, but the mug didn't survive unscathed.  It's now cracked.

[on the desk]

>purloin mug. drop mug. push mug
[Purloined.]

Dropped.

You bat at the mug a few times, and they finally drop to the floor.

It put on a brave face, but the mug finally shatters.

[Your score has just gone up by four points.]

[on the desk]

>purloin mug. drop mug. push mug
[Purloined.]

Dropped.

You bat at the broken pieces of a mug a few times, and they finally drop to the floor.

The pieces of the mug are no worse for wear than they were before.

[on the desk]

>purloin mug. drop mug. push mug
[Purloined.]

Dropped.

You bat at the broken pieces of a mug a few times, and they finally drop to the floor.

The pieces of the mug are no worse for wear than they were before.

[on the desk]

>purloin mug
[Purloined.]

[on the desk]

* * *

>drop mug
Dropped.

[on the desk]

>pick up mug
You pick up the broken pieces of a mug.

[on the desk, holding some broken pieces of a mug]

>get on workbench
You get onto the workbench.

The workbench is a warm painted wood, in stark contrast to the cold metal desk right next to it.  This is where the magic happens, if "magic" is the appearance of a lot of things that roll around.

On the workbench you can see some construction paper.

[on the workbench, holding some broken pieces of a mug]

>x paper
This paper is a deep alluring blue, perfect for arts and crafts.  It's only too bad someone already drew a bunch of white lines all over it.

[on the workbench, holding some broken pieces of a mug]

>up
What do you want to up?

[on the workbench, holding some broken pieces of a mug]

>down
You hop down off of the workbench.

Neon's bedroom
The lights are off and there are no windows, but the room is lit well enough by the cyan glow coming from Neon's desk and the blinking LEDs on the tall machine in the corner.

The desk and an adjacent workbench run along the entire length of one wall.  Some shelves take up the opposite wall, stopping short of the corner to make room for a tall machine.  In the center of the room is a bed, unmade, a blanket hanging half off one side; it's framed by a nightstand and a closet door in the western wall.  The bedroom door to the east is, of course, closed.

A little white pamphlet lies on the floor near the door.

The floor is strewn with innumerable strata of dirty laundry, all of which is soft and comfortable under your paws.

(From down here, you can't see what's on the various raised surfaces around the room.)

[on the floor, holding some broken pieces of a mug]

>leave
(first opening the closet door)
You strain, but you just can't reach the doorknob from here.

[on the floor, holding some broken pieces of a mug]

* * *

>talk to pearl
You can't see any such thing.

[on the floor]

>pull blanket
You tug on the blanket.  It slides off the bed and on top of you, bringing its contents with it.  A little flailing manages to kick it off of you, and you're greeted by a scowling face.

Purrl crosses her arms.  "Star Anise!!  What are you doing here!  I was taking a lovely nap, and then I had a nightmare that Star Anise woke me up, and then it wasn't a nightmare it was real!!  This is my sleep place that I found, go away!!"

You adopt an action pose, to convey how much action you're currently ready for.  "Oh!!!!!  Purrl!  I'm so glad to see you!!  Listen we're trapped in the Chamber of Despair and I've been trying to go away but I can't because of the trapped!  We gotta make a daringly cool escape!!  Do you have any explosives or maybe a cool gun."

"No!  Let me nap!!!"

"Yeah!!  A nap after we escape sounds great!!  Team Star Purrl Anise Fish Squad let's go!!"

[Your score has just gone up by five points.]

[on the floor]

>talk to purrl
Purrl folds her arms and looks off in a different direction.

[on the floor]

* * *

>x east
You see nothing unexpected in that direction.

[on the floor]

* * *

>stack laundry
You're more in the business of knocking things down.

[on the floor]

>x panel
This glowing rectangle is clearly the secret to your escape.  Also, it glows, and that makes you want to touch it very badly.

[on the floor]

>touch panel
You stand on your tippy toes, but you just can't reach the glowing panel.  You AOOWWR in frustration.

[on the floor]

* * *

>get on purrl
"Don't step on me Star Anise!!"  Purrl grumbles and pushes you away.  You try to explain that you need to be taller, but she isn't swayed.  If only you had a more concrete excuse...

[on the floor]

>show panel to purrl
You point up at the panel.  "I think that opens the door!!  Also it glows a lot and I wanna touch it.  But it's too tall up!  Gimme a boost!"

Purrl puts her paws squarely on her hips.  "I'm not giving you any boots!  Find something else to stand on!!"

"Like what??  Everything in here is real big or real shirt!"  You stand on one of the dirty shirts on the floor.  "Look it doesn't make me any taller at all!  Not even one taller!!  I can't escape like this!"

"Mmmmnnmnnmmnnnn.  I dunno."  Purrl licks her paw in a lovely manner.  "But okay.  But only if you don't bother M.O.R.S.E.L."

[Your score has just gone up by five points.]

[on the floor]

>get on purrl
Purrl reluctantly leans down for you, and you clamber awkwardly on top of her helmet.

[on Purrl]

>touch panel
You pap your paws against the panel.  It makes some delightful noises and flashes red for a moment.

Purrl folds her arms.

[on Purrl]

* * *

>take blanket
You tug on the blanket.  It slides off the bed and on top of you, bringing its contents with it.  A little flailing manages to kick it off of you, and you're greeted by a scowling face.

Purrl crosses her arms.  "Star Anise!!  What are you doing here!  I was taking a lovely nap, and then I had a nightmare that Star Anise woke me up, and then it wasn't a nightmare it was real!!  This is my sleep place that I found, go away!!"

You adopt an action pose, to convey how much action you're currently ready for.  "Oh!!!!!  Purrl!  I'm so glad to see you!!  Listen we're trapped in the Chamber of Despair and I've been trying to go away but I can't because of the trapped!  We gotta make a daringly cool escape!!  Do you have any explosives or maybe a cool gun."

"No!  Let me nap!!!"

"Yeah!!  A nap after we escape sounds great!!  Team Star Purrl Anise Fish Squad let's go!!"

[Your score has just gone up by five points.]

[on the floor]